timestamp,amount,running_balance,month_year,category
2023-01-28 00:00:00+00:00,276.19,55889.63,2023-01,transfer
2023-01-28 00:00:00+00:00,-30.51,55920.14,2023-01,shopping
2023-01-28 00:00:00+00:00,50.4,55869.74,2023-01,transfer
2023-01-28 00:00:00+00:00,-13.5,55883.24,2023-01,transfer
2023-01-28 00:00:00+00:00,20.25,55862.99,2023-01,taxes
2023-01-27 00:00:00+00:00,-8.44,55871.43,2023-01,transfer
2023-01-27 00:00:00+00:00,50.59,55820.84,2023-01,transfer
2023-01-27 00:00:00+00:00,20.13,55800.71,2023-01,transfer
2023-01-27 00:00:00+00:00,-20.56,55821.27,2023-01,transport
2023-01-27 00:00:00+00:00,-2.99,55824.26,2023-01,finances
2023-01-27 00:00:00+00:00,-23.39,55847.65,2023-01,groceries / food spend
2023-01-27 00:00:00+00:00,-4.13,55851.78,2023-01,shopping
2023-01-25 00:00:00+00:00,70.0,55781.78,2023-01,transfer
2023-01-25 00:00:00+00:00,-24.5,55806.28,2023-01,entertainment
2023-01-25 00:00:00+00:00,-10.0,55816.28,2023-01,transfer
2023-01-25 00:00:00+00:00,-0.41,55816.69,2023-01,savings
2023-01-25 00:00:00+00:00,-15.71,55832.4,2023-01,shopping
2023-01-25 00:00:00+00:00,-0.5,55832.9,2023-01,savings
2023-01-25 00:00:00+00:00,-10.5,55843.4,2023-01,entertainment
2023-01-23 00:00:00+00:00,-30.0,55873.4,2023-01,finances
2023-01-23 00:00:00+00:00,32.5,55840.9,2023-01,transfer
2023-01-23 00:00:00+00:00,-100.0,55940.9,2023-01,transfer
2023-01-23 00:00:00+00:00,-1.57,55942.47,2023-01,savings
2023-01-23 00:00:00+00:00,-16.95,55959.42,2023-01,transfer
2023-01-22 00:00:00+00:00,-5.0,55964.42,2023-01,shopping
2023-01-22 00:00:00+00:00,-0.01,55964.43,2023-01,savings
2023-01-22 00:00:00+00:00,-39.25,56003.68,2023-01,bills and utilities
2023-01-22 00:00:00+00:00,-74.03,56077.71,2023-01,shopping
2023-01-22 00:00:00+00:00,-35.25,56112.96,2023-01,finances
2023-01-20 00:00:00+00:00,-150.0,56262.96,2023-01,rent
2023-01-20 00:00:00+00:00,21.52,56241.44,2023-01,taxes
2023-01-20 00:00:00+00:00,-550.0,56791.44,2023-01,business services
2023-01-20 00:00:00+00:00,328.8,56462.64,2023-01,taxes
2023-01-19 00:00:00+00:00,-11.14,56473.78,2023-01,shopping
2023-01-19 00:00:00+00:00,1450.42,55023.36,2023-01,salary
2023-01-18 00:00:00+00:00,82.21,54941.15,2023-01,finances
2023-01-17 00:00:00+00:00,174.88,54766.27,2023-01,transfer
2023-01-17 00:00:00+00:00,-12.73,54779.0,2023-01,finances
2023-01-17 00:00:00+00:00,-40.74,54819.74,2023-01,finances
2023-01-17 00:00:00+00:00,-20.0,54839.74,2023-01,transport
2023-01-17 00:00:00+00:00,-0.61,54840.35,2023-01,savings
2023-01-17 00:00:00+00:00,-6.37,54846.72,2023-01,groceries / food spend
2023-01-15 00:00:00+00:00,-63.64,54910.36,2023-01,groceries / food spend
2023-01-15 00:00:00+00:00,-0.55,54910.91,2023-01,savings
2023-01-15 00:00:00+00:00,-30.47,54941.38,2023-01,shopping
2023-01-15 00:00:00+00:00,-0.5,54941.88,2023-01,savings
2023-01-15 00:00:00+00:00,1.11,54940.77,2023-01,shopping
2023-01-15 00:00:00+00:00,-13.49,54954.26,2023-01,shopping
2023-01-14 00:00:00+00:00,-2.0,54956.26,2023-01,entertainment
2023-01-14 00:00:00+00:00,-20.5,54976.76,2023-01,entertainment
2023-01-14 00:00:00+00:00,54.08,54922.68,2023-01,entertainment
2023-01-12 00:00:00+00:00,-0.38,54923.06,2023-01,savings
2023-01-12 00:00:00+00:00,-23.11,54946.17,2023-01,transport
2023-01-11 00:00:00+00:00,50.0,54896.17,2023-01,finances
2023-01-11 00:00:00+00:00,40.61,54855.56,2023-01,transfer
2023-01-11 00:00:00+00:00,22.42,54833.14,2023-01,taxes
2023-01-11 00:00:00+00:00,-20.74,54853.88,2023-01,holidays
2023-01-10 00:00:00+00:00,-40.0,54893.88,2023-01,finances
2023-01-10 00:00:00+00:00,-5.63,54899.51,2023-01,groceries / food spend
2023-01-10 00:00:00+00:00,40.0,54859.51,2023-01,transfer
2023-01-10 00:00:00+00:00,50.36,54809.15,2023-01,finances
2023-01-10 00:00:00+00:00,-39.39,54848.54,2023-01,transfer
2023-01-10 00:00:00+00:00,-24.95,54873.49,2023-01,bills and utilities
2023-01-09 00:00:00+00:00,-20.2,54893.69,2023-01,transport
2023-01-09 00:00:00+00:00,-20.75,54914.44,2023-01,taxes
2023-01-09 00:00:00+00:00,-0.41,54914.85,2023-01,savings
2023-01-09 00:00:00+00:00,70.0,54844.85,2023-01,transfer
2023-01-08 00:00:00+00:00,-0.01,54844.86,2023-01,savings
2023-01-08 00:00:00+00:00,20.76,54824.1,2023-01,taxes
2023-01-08 00:00:00+00:00,-11.64,54835.74,2023-01,fees and charges
2023-01-08 00:00:00+00:00,-100.0,54935.74,2023-01,rent
2023-01-08 00:00:00+00:00,-10.0,54945.74,2023-01,entertainment
2023-01-08 00:00:00+00:00,-0.71,54946.45,2023-01,savings
2023-01-08 00:00:00+00:00,-1.04,54947.49,2023-01,savings
2023-01-08 00:00:00+00:00,-24.31,54971.8,2023-01,groceries / food spend
2023-01-07 00:00:00+00:00,-82.37,55054.17,2023-01,bills and utilities
2023-01-07 00:00:00+00:00,-1.15,55055.32,2023-01,savings
2023-01-07 00:00:00+00:00,-81.24,55136.56,2023-01,transfer
2023-01-06 00:00:00+00:00,-28.25,55164.81,2023-01,bills and utilities
2023-01-06 00:00:00+00:00,22.42,55142.39,2023-01,taxes
2023-01-06 00:00:00+00:00,-12.89,55155.28,2023-01,groceries / food spend
2023-01-06 00:00:00+00:00,-49.2,55204.48,2023-01,bills and utilities
2023-01-06 00:00:00+00:00,-9.71,55214.19,2023-01,home and garden
2023-01-06 00:00:00+00:00,344.89,54869.3,2023-01,taxes
2023-01-06 00:00:00+00:00,137.6,54731.7,2023-01,transfer
2023-01-06 00:00:00+00:00,61.89,54669.81,2023-01,transfer
2023-01-06 00:00:00+00:00,-0.01,54669.82,2023-01,savings
2023-01-06 00:00:00+00:00,-5.0,54674.82,2023-01,shopping
2023-01-05 00:00:00+00:00,-60.0,54734.82,2023-01,transfer
2023-01-05 00:00:00+00:00,-1.89,54736.71,2023-01,savings
2023-01-05 00:00:00+00:00,-6.81,54743.52,2023-01,finances
2023-01-05 00:00:00+00:00,-7.99,54751.51,2023-01,shopping
2023-01-05 00:00:00+00:00,-0.33,54751.84,2023-01,transfer
2023-01-05 00:00:00+00:00,-12.73,54764.57,2023-01,finances
2023-01-05 00:00:00+00:00,-4.91,54769.48,2023-01,groceries / food spend
2023-01-05 00:00:00+00:00,-20.0,54789.48,2023-01,shopping
2023-01-04 00:00:00+00:00,8.3,54781.18,2023-01,transfer
2023-01-04 00:00:00+00:00,70.0,54711.18,2023-01,transfer
2023-01-04 00:00:00+00:00,59.17,54652.01,2023-01,transfer
2023-01-04 00:00:00+00:00,-15.95,54667.96,2023-01,transfer
2023-01-04 00:00:00+00:00,-7.41,54675.37,2023-01,shopping
2023-01-04 00:00:00+00:00,-3.13,54678.5,2023-01,finances
2023-01-04 00:00:00+00:00,-100.0,54778.5,2023-01,transfer
2023-01-04 00:00:00+00:00,100.0,54678.5,2023-01,transfer
2023-01-04 00:00:00+00:00,-3.59,54682.09,2023-01,business services
2023-01-04 00:00:00+00:00,25.0,54657.09,2023-01,transfer
2023-01-04 00:00:00+00:00,-130.0,54787.09,2023-01,rent
2023-01-03 00:00:00+00:00,0.89,54786.2,2023-01,transfer
2023-01-03 00:00:00+00:00,-0.41,54786.61,2023-01,savings
2023-01-03 00:00:00+00:00,130.0,54656.61,2023-01,transfer
2023-01-03 00:00:00+00:00,3.79,54652.82,2023-01,transfer
2023-01-03 00:00:00+00:00,-23.11,54675.93,2023-01,transport
2023-01-03 00:00:00+00:00,35.49,54640.44,2023-01,entertainment
2023-01-03 00:00:00+00:00,-0.01,54640.45,2023-01,savings
2023-01-03 00:00:00+00:00,-2.99,54643.44,2023-01,entertainment
2023-01-03 00:00:00+00:00,-30.0,54673.44,2023-01,shopping
2023-01-03 00:00:00+00:00,25.71,54647.73,2023-01,transfer
2023-01-03 00:00:00+00:00,-40.0,54687.73,2023-01,transfer
2023-01-03 00:00:00+00:00,-5.0,54692.73,2023-01,groceries / food spend
2023-01-02 00:00:00+00:00,20.12,54672.61,2023-01,transfer
2023-01-02 00:00:00+00:00,-16.32,54688.93,2023-01,transfer
2023-01-02 00:00:00+00:00,10.0,54678.93,2023-01,transfer
2023-01-02 00:00:00+00:00,-0.59,54679.52,2023-01,savings
2023-01-01 00:00:00+00:00,-50.23,54729.75,2023-01,bills and utilities
2023-01-01 00:00:00+00:00,-0.01,54729.76,2023-01,fees and charges
2023-01-01 00:00:00+00:00,-508.72,55238.48,2023-01,transfer
2023-01-01 00:00:00+00:00,-23.94,55262.42,2023-01,groceries / food spend
2023-01-01 00:00:00+00:00,-0.01,55262.43,2023-01,finances
2023-01-01 00:00:00+00:00,-0.01,55262.44,2023-01,shopping
2023-01-01 00:00:00+00:00,0.0,55262.44,2023-01,shopping
2023-01-01 00:00:00+00:00,-0.02,55262.46,2023-01,groceries / food spend
2023-01-01 00:00:00+00:00,-0.01,55262.47,2023-01,groceries / food spend
2023-01-01 00:00:00+00:00,-0.01,55262.48,2023-01,groceries / food spend
2023-01-01 00:00:00+00:00,-0.01,55262.49,2023-01,groceries / food spend
2023-01-01 00:00:00+00:00,-0.01,55262.5,2023-01,transport
2023-01-01 00:00:00+00:00,-200.0,55462.5,2023-01,restaurants / eating out / delivery
2023-01-01 00:00:00+00:00,-0.01,55462.51,2023-01,home and garden
2023-01-01 00:00:00+00:00,-0.02,55462.53,2023-01,fees and charges
2023-01-01 00:00:00+00:00,-0.01,55462.54,2023-01,transport
2023-01-01 00:00:00+00:00,-0.02,55462.56,2023-01,entertainment
2023-01-01 00:00:00+00:00,-0.01,55462.57,2023-01,fees and charges
2023-01-01 00:00:00+00:00,-23.99,55486.56,2023-01,groceries / food spend
2023-01-01 00:00:00+00:00,-26.29,55512.85,2023-01,transfer
2023-01-01 00:00:00+00:00,-16.2,55529.05,2023-01,business services
2023-01-01 00:00:00+00:00,-10.0,55539.05,2023-01,bills and utilities
2023-01-01 00:00:00+00:00,-9.92,55548.97,2023-01,finances
2023-01-01 00:00:00+00:00,-7.43,55556.4,2023-01,finances
2023-01-01 00:00:00+00:00,-10.0,55566.4,2023-01,bills and utilities
2022-12-28 00:00:00+00:00,370.64,55195.76,2022-12,transfer
2022-12-28 00:00:00+00:00,-71.22,55266.98,2022-12,shopping
2022-12-28 00:00:00+00:00,24.84,55242.14,2022-12,transfer
2022-12-28 00:00:00+00:00,-32.72,55274.86,2022-12,transfer
2022-12-28 00:00:00+00:00,24.48,55250.38,2022-12,taxes
2022-12-27 00:00:00+00:00,-5.53,55255.91,2022-12,transfer
2022-12-27 00:00:00+00:00,107.99,55147.92,2022-12,transfer
2022-12-27 00:00:00+00:00,15.86,55132.06,2022-12,transfer
2022-12-27 00:00:00+00:00,-20.56,55152.62,2022-12,transport
2022-12-27 00:00:00+00:00,-2.29,55154.91,2022-12,finances
2022-12-27 00:00:00+00:00,-15.65,55170.56,2022-12,groceries / food spend
2022-12-27 00:00:00+00:00,-7.56,55178.12,2022-12,shopping
2022-12-25 00:00:00+00:00,70.0,55108.12,2022-12,transfer
2022-12-25 00:00:00+00:00,-39.72,55147.84,2022-12,entertainment
2022-12-25 00:00:00+00:00,-10.0,55157.84,2022-12,transfer
2022-12-25 00:00:00+00:00,-0.41,55158.25,2022-12,savings
2022-12-25 00:00:00+00:00,-14.75,55173.0,2022-12,shopping
2022-12-25 00:00:00+00:00,-0.5,55173.5,2022-12,savings
2022-12-25 00:00:00+00:00,-15.22,55188.72,2022-12,entertainment
2022-12-23 00:00:00+00:00,-30.33,55219.05,2022-12,finances
2022-12-23 00:00:00+00:00,32.5,55186.55,2022-12,transfer
2022-12-23 00:00:00+00:00,-100.0,55286.55,2022-12,transfer
2022-12-23 00:00:00+00:00,-1.57,55288.12,2022-12,savings
2022-12-23 00:00:00+00:00,-24.6,55312.72,2022-12,transfer
2022-12-22 00:00:00+00:00,-1.12,55313.84,2022-12,shopping
2022-12-22 00:00:00+00:00,-0.01,55313.85,2022-12,savings
2022-12-22 00:00:00+00:00,-39.25,55353.1,2022-12,bills and utilities
2022-12-22 00:00:00+00:00,-36.59,55389.69,2022-12,shopping
2022-12-22 00:00:00+00:00,-24.62,55414.31,2022-12,finances
2022-12-20 00:00:00+00:00,-150.0,55564.31,2022-12,rent
2022-12-20 00:00:00+00:00,20.29,55544.02,2022-12,taxes
2022-12-20 00:00:00+00:00,-677.11,56221.13,2022-12,business services
2022-12-20 00:00:00+00:00,334.31,55886.82,2022-12,taxes
2022-12-19 00:00:00+00:00,-9.27,55896.09,2022-12,shopping
2022-12-19 00:00:00+00:00,1450.42,54445.67,2022-12,salary
2022-12-18 00:00:00+00:00,67.94,54377.73,2022-12,finances
2022-12-17 00:00:00+00:00,239.04,54138.69,2022-12,transfer
2022-12-17 00:00:00+00:00,-17.5,54156.19,2022-12,finances
2022-12-17 00:00:00+00:00,-40.0,54196.19,2022-12,finances
2022-12-17 00:00:00+00:00,-21.74,54217.93,2022-12,transport
2022-12-17 00:00:00+00:00,-0.63,54218.56,2022-12,savings
2022-12-17 00:00:00+00:00,-6.37,54224.93,2022-12,groceries / food spend
2022-12-15 00:00:00+00:00,-25.47,54250.4,2022-12,groceries / food spend
2022-12-15 00:00:00+00:00,-0.55,54250.95,2022-12,savings
2022-12-15 00:00:00+00:00,-15.45,54266.4,2022-12,shopping
2022-12-15 00:00:00+00:00,-0.51,54266.91,2022-12,savings
2022-12-15 00:00:00+00:00,-3.59,54270.5,2022-12,shopping
2022-12-15 00:00:00+00:00,-10.0,54280.5,2022-12,shopping
2022-12-14 00:00:00+00:00,-5.27,54285.77,2022-12,entertainment
2022-12-14 00:00:00+00:00,-36.1,54321.87,2022-12,entertainment
2022-12-14 00:00:00+00:00,78.31,54243.56,2022-12,entertainment
2022-12-12 00:00:00+00:00,-0.45,54244.01,2022-12,savings
2022-12-12 00:00:00+00:00,-23.11,54267.12,2022-12,transport
2022-12-11 00:00:00+00:00,50.0,54217.12,2022-12,finances
2022-12-11 00:00:00+00:00,42.93,54174.19,2022-12,transfer
2022-12-11 00:00:00+00:00,22.42,54151.77,2022-12,taxes
2022-12-11 00:00:00+00:00,-17.0,54168.77,2022-12,holidays
2022-12-10 00:00:00+00:00,-41.22,54209.99,2022-12,finances
2022-12-10 00:00:00+00:00,-5.0,54214.99,2022-12,groceries / food spend
2022-12-10 00:00:00+00:00,41.48,54173.51,2022-12,transfer
2022-12-10 00:00:00+00:00,50.36,54123.15,2022-12,finances
2022-12-10 00:00:00+00:00,-30.0,54153.15,2022-12,transfer
2022-12-10 00:00:00+00:00,-21.67,54174.82,2022-12,bills and utilities
2022-12-09 00:00:00+00:00,-22.48,54197.3,2022-12,transport
2022-12-09 00:00:00+00:00,-20.17,54217.47,2022-12,taxes
2022-12-09 00:00:00+00:00,-0.41,54217.88,2022-12,savings
2022-12-09 00:00:00+00:00,98.28,54119.6,2022-12,transfer
2022-12-08 00:00:00+00:00,-0.01,54119.61,2022-12,savings
2022-12-08 00:00:00+00:00,21.42,54098.19,2022-12,taxes
2022-12-08 00:00:00+00:00,-14.99,54113.18,2022-12,fees and charges
2022-12-08 00:00:00+00:00,-100.0,54213.18,2022-12,rent
2022-12-08 00:00:00+00:00,-1.63,54214.81,2022-12,entertainment
2022-12-08 00:00:00+00:00,-0.69,54215.5,2022-12,savings
2022-12-08 00:00:00+00:00,-1.11,54216.61,2022-12,savings
2022-12-08 00:00:00+00:00,-22.05,54238.66,2022-12,groceries / food spend
2022-12-07 00:00:00+00:00,-82.37,54321.03,2022-12,bills and utilities
2022-12-07 00:00:00+00:00,-1.15,54322.18,2022-12,savings
2022-12-07 00:00:00+00:00,-45.99,54368.17,2022-12,transfer
2022-12-06 00:00:00+00:00,-28.25,54396.42,2022-12,bills and utilities
2022-12-06 00:00:00+00:00,22.42,54374.0,2022-12,taxes
2022-12-06 00:00:00+00:00,-21.53,54395.53,2022-12,groceries / food spend
2022-12-06 00:00:00+00:00,-50.0,54445.53,2022-12,bills and utilities
2022-12-06 00:00:00+00:00,-9.71,54455.24,2022-12,home and garden
2022-12-06 00:00:00+00:00,360.86,54094.38,2022-12,taxes
2022-12-06 00:00:00+00:00,145.48,53948.9,2022-12,transfer
2022-12-06 00:00:00+00:00,66.54,53882.36,2022-12,transfer
2022-12-06 00:00:00+00:00,-0.01,53882.37,2022-12,savings
2022-12-06 00:00:00+00:00,6.0,53876.37,2022-12,shopping
2022-12-05 00:00:00+00:00,-60.0,53936.37,2022-12,transfer
2022-12-05 00:00:00+00:00,-1.89,53938.26,2022-12,savings
2022-12-05 00:00:00+00:00,-6.08,53944.34,2022-12,finances
2022-12-05 00:00:00+00:00,-4.98,53949.32,2022-12,shopping
2022-12-05 00:00:00+00:00,-23.15,53972.47,2022-12,transfer
2022-12-05 00:00:00+00:00,-12.36,53984.83,2022-12,finances
2022-12-05 00:00:00+00:00,-6.37,53991.2,2022-12,groceries / food spend
2022-12-05 00:00:00+00:00,-20.0,54011.2,2022-12,shopping
2022-12-04 00:00:00+00:00,11.44,53999.76,2022-12,transfer
2022-12-04 00:00:00+00:00,70.0,53929.76,2022-12,transfer
2022-12-04 00:00:00+00:00,44.22,53885.54,2022-12,transfer
2022-12-04 00:00:00+00:00,-16.96,53902.5,2022-12,transfer
2022-12-04 00:00:00+00:00,-5.0,53907.5,2022-12,shopping
2022-12-04 00:00:00+00:00,-3.07,53910.57,2022-12,finances
2022-12-04 00:00:00+00:00,-100.0,54010.57,2022-12,transfer
2022-12-04 00:00:00+00:00,46.55,53964.02,2022-12,transfer
2022-12-04 00:00:00+00:00,-3.59,53967.61,2022-12,business services
2022-12-04 00:00:00+00:00,25.0,53942.61,2022-12,transfer
2022-12-04 00:00:00+00:00,-130.0,54072.61,2022-12,rent
2022-12-03 00:00:00+00:00,0.89,54071.72,2022-12,transfer
2022-12-03 00:00:00+00:00,-0.41,54072.13,2022-12,savings
2022-12-03 00:00:00+00:00,130.0,53942.13,2022-12,transfer
2022-12-03 00:00:00+00:00,7.0,53935.13,2022-12,transfer
2022-12-03 00:00:00+00:00,-28.54,53963.67,2022-12,transport
2022-12-03 00:00:00+00:00,46.68,53916.99,2022-12,entertainment
2022-12-03 00:00:00+00:00,-0.01,53917.0,2022-12,savings
2022-12-03 00:00:00+00:00,-2.99,53919.99,2022-12,entertainment
2022-12-03 00:00:00+00:00,-30.0,53949.99,2022-12,shopping
2022-12-03 00:00:00+00:00,29.42,53920.57,2022-12,transfer
2022-12-03 00:00:00+00:00,-32.36,53952.93,2022-12,transfer
2022-12-03 00:00:00+00:00,-2.26,53955.19,2022-12,groceries / food spend
2022-12-02 00:00:00+00:00,33.38,53921.81,2022-12,transfer
2022-12-02 00:00:00+00:00,-30.0,53951.81,2022-12,transfer
2022-12-02 00:00:00+00:00,10.55,53941.26,2022-12,transfer
2022-12-02 00:00:00+00:00,-0.5,53941.76,2022-12,savings
2022-12-01 00:00:00+00:00,-46.82,53988.58,2022-12,bills and utilities
2022-12-01 00:00:00+00:00,-0.01,53988.59,2022-12,fees and charges
2022-12-01 00:00:00+00:00,-352.25,54340.84,2022-12,transfer
2022-12-01 00:00:00+00:00,-39.99,54380.83,2022-12,groceries / food spend
2022-12-01 00:00:00+00:00,-0.01,54380.84,2022-12,finances
2022-12-01 00:00:00+00:00,-0.01,54380.85,2022-12,shopping
2022-12-01 00:00:00+00:00,-0.0,54380.85,2022-12,shopping
2022-12-01 00:00:00+00:00,-0.01,54380.86,2022-12,groceries / food spend
2022-12-01 00:00:00+00:00,-0.01,54380.87,2022-12,groceries / food spend
2022-12-01 00:00:00+00:00,-0.01,54380.88,2022-12,groceries / food spend
2022-12-01 00:00:00+00:00,-0.02,54380.9,2022-12,groceries / food spend
2022-12-01 00:00:00+00:00,-0.01,54380.91,2022-12,transport
2022-12-01 00:00:00+00:00,-200.0,54580.91,2022-12,restaurants / eating out / delivery
2022-12-01 00:00:00+00:00,-0.01,54580.92,2022-12,home and garden
2022-12-01 00:00:00+00:00,-0.01,54580.93,2022-12,fees and charges
2022-12-01 00:00:00+00:00,-0.01,54580.94,2022-12,transport
2022-12-01 00:00:00+00:00,-0.01,54580.95,2022-12,entertainment
2022-12-01 00:00:00+00:00,-0.01,54580.96,2022-12,fees and charges
2022-12-01 00:00:00+00:00,-19.51,54600.47,2022-12,groceries / food spend
2022-12-01 00:00:00+00:00,-22.2,54622.67,2022-12,transfer
2022-12-01 00:00:00+00:00,-12.54,54635.21,2022-12,business services
2022-12-01 00:00:00+00:00,-8.6,54643.81,2022-12,bills and utilities
2022-12-01 00:00:00+00:00,-10.0,54653.81,2022-12,finances
2022-12-01 00:00:00+00:00,-10.0,54663.81,2022-12,finances
2022-12-01 00:00:00+00:00,-10.0,54673.81,2022-12,bills and utilities
2022-11-28 00:00:00+00:00,420.0,54253.81,2022-11,transfer
2022-11-28 00:00:00+00:00,-36.59,54290.4,2022-11,shopping
2022-11-28 00:00:00+00:00,40.0,54250.4,2022-11,transfer
2022-11-28 00:00:00+00:00,-36.66,54287.06,2022-11,transfer
2022-11-28 00:00:00+00:00,23.28,54263.78,2022-11,taxes
2022-11-27 00:00:00+00:00,-7.93,54271.71,2022-11,transfer
2022-11-27 00:00:00+00:00,50.59,54221.12,2022-11,transfer
2022-11-27 00:00:00+00:00,15.86,54205.26,2022-11,transfer
2022-11-27 00:00:00+00:00,-17.66,54222.92,2022-11,transport
2022-11-27 00:00:00+00:00,-2.99,54225.91,2022-11,finances
2022-11-27 00:00:00+00:00,-6.65,54232.56,2022-11,groceries / food spend
2022-11-27 00:00:00+00:00,-8.26,54240.82,2022-11,shopping
2022-11-25 00:00:00+00:00,127.69,54113.13,2022-11,transfer
2022-11-25 00:00:00+00:00,-19.11,54132.24,2022-11,entertainment
2022-11-25 00:00:00+00:00,-16.54,54148.78,2022-11,transfer
2022-11-25 00:00:00+00:00,-0.41,54149.19,2022-11,savings
2022-11-25 00:00:00+00:00,-36.59,54185.78,2022-11,shopping
2022-11-25 00:00:00+00:00,-0.5,54186.28,2022-11,savings
2022-11-25 00:00:00+00:00,-13.21,54199.49,2022-11,entertainment
2022-11-23 00:00:00+00:00,-40.55,54240.04,2022-11,finances
2022-11-23 00:00:00+00:00,32.5,54207.54,2022-11,transfer
2022-11-23 00:00:00+00:00,-100.0,54307.54,2022-11,transfer
2022-11-23 00:00:00+00:00,-1.57,54309.11,2022-11,savings
2022-11-23 00:00:00+00:00,-20.0,54329.11,2022-11,transfer
2022-11-22 00:00:00+00:00,-5.0,54334.11,2022-11,shopping
2022-11-22 00:00:00+00:00,-0.01,54334.12,2022-11,savings
2022-11-22 00:00:00+00:00,-37.3,54371.42,2022-11,bills and utilities
2022-11-22 00:00:00+00:00,-36.59,54408.01,2022-11,shopping
2022-11-22 00:00:00+00:00,-36.59,54444.6,2022-11,finances
2022-11-20 00:00:00+00:00,-150.0,54594.6,2022-11,rent
2022-11-20 00:00:00+00:00,22.42,54572.18,2022-11,taxes
2022-11-20 00:00:00+00:00,-550.0,55122.18,2022-11,business services
2022-11-20 00:00:00+00:00,359.01,54763.17,2022-11,taxes
2022-11-19 00:00:00+00:00,-20.43,54783.6,2022-11,shopping
2022-11-19 00:00:00+00:00,1450.42,53333.18,2022-11,salary
2022-11-18 00:00:00+00:00,82.21,53250.97,2022-11,finances
2022-11-17 00:00:00+00:00,123.82,53127.15,2022-11,transfer
2022-11-17 00:00:00+00:00,-10.12,53137.27,2022-11,finances
2022-11-17 00:00:00+00:00,-40.0,53177.27,2022-11,finances
2022-11-17 00:00:00+00:00,-20.0,53197.27,2022-11,transport
2022-11-17 00:00:00+00:00,-0.56,53197.83,2022-11,savings
2022-11-17 00:00:00+00:00,-2.46,53200.29,2022-11,groceries / food spend
2022-11-15 00:00:00+00:00,-32.0,53232.29,2022-11,groceries / food spend
2022-11-15 00:00:00+00:00,-0.48,53232.77,2022-11,savings
2022-11-15 00:00:00+00:00,-15.45,53248.22,2022-11,shopping
2022-11-15 00:00:00+00:00,-0.5,53248.72,2022-11,savings
2022-11-15 00:00:00+00:00,-3.59,53252.31,2022-11,shopping
2022-11-15 00:00:00+00:00,-10.0,53262.31,2022-11,shopping
2022-11-14 00:00:00+00:00,-2.0,53264.31,2022-11,entertainment
2022-11-14 00:00:00+00:00,-3.89,53268.2,2022-11,entertainment
2022-11-14 00:00:00+00:00,43.5,53224.7,2022-11,entertainment
2022-11-12 00:00:00+00:00,-0.41,53225.11,2022-11,savings
2022-11-12 00:00:00+00:00,-33.84,53258.95,2022-11,transport
2022-11-11 00:00:00+00:00,57.51,53201.44,2022-11,finances
2022-11-11 00:00:00+00:00,54.59,53146.85,2022-11,transfer
2022-11-11 00:00:00+00:00,22.97,53123.88,2022-11,taxes
2022-11-11 00:00:00+00:00,-20.55,53144.43,2022-11,holidays
2022-11-10 00:00:00+00:00,-40.0,53184.43,2022-11,finances
2022-11-10 00:00:00+00:00,-5.37,53189.8,2022-11,groceries / food spend
2022-11-10 00:00:00+00:00,40.0,53149.8,2022-11,transfer
2022-11-10 00:00:00+00:00,50.36,53099.44,2022-11,finances
2022-11-10 00:00:00+00:00,-35.26,53134.7,2022-11,transfer
2022-11-10 00:00:00+00:00,-24.5,53159.2,2022-11,bills and utilities
2022-11-09 00:00:00+00:00,-23.37,53182.57,2022-11,transport
2022-11-09 00:00:00+00:00,-20.56,53203.13,2022-11,taxes
2022-11-09 00:00:00+00:00,-0.41,53203.54,2022-11,savings
2022-11-09 00:00:00+00:00,91.27,53112.27,2022-11,transfer
2022-11-08 00:00:00+00:00,-0.01,53112.28,2022-11,savings
2022-11-08 00:00:00+00:00,22.64,53089.64,2022-11,taxes
2022-11-08 00:00:00+00:00,-14.99,53104.63,2022-11,fees and charges
2022-11-08 00:00:00+00:00,-100.0,53204.63,2022-11,rent
2022-11-08 00:00:00+00:00,-10.0,53214.63,2022-11,entertainment
2022-11-08 00:00:00+00:00,-0.74,53215.37,2022-11,savings
2022-11-08 00:00:00+00:00,-1.04,53216.41,2022-11,savings
2022-11-08 00:00:00+00:00,-24.31,53240.72,2022-11,groceries / food spend
2022-11-07 00:00:00+00:00,-82.37,53323.09,2022-11,bills and utilities
2022-11-07 00:00:00+00:00,-1.02,53324.11,2022-11,savings
2022-11-07 00:00:00+00:00,-82.28,53406.39,2022-11,transfer
2022-11-06 00:00:00+00:00,-25.1,53431.49,2022-11,bills and utilities
2022-11-06 00:00:00+00:00,22.42,53409.07,2022-11,taxes
2022-11-06 00:00:00+00:00,-12.89,53421.96,2022-11,groceries / food spend
2022-11-06 00:00:00+00:00,-43.65,53465.61,2022-11,bills and utilities
2022-11-06 00:00:00+00:00,-5.59,53471.2,2022-11,home and garden
2022-11-06 00:00:00+00:00,370.67,53100.53,2022-11,taxes
2022-11-06 00:00:00+00:00,190.84,52909.69,2022-11,transfer
2022-11-06 00:00:00+00:00,97.17,52812.52,2022-11,transfer
2022-11-06 00:00:00+00:00,-0.01,52812.53,2022-11,savings
2022-11-06 00:00:00+00:00,-5.0,52817.53,2022-11,shopping
2022-11-05 00:00:00+00:00,-47.13,52864.66,2022-11,transfer
2022-11-05 00:00:00+00:00,-2.11,52866.77,2022-11,savings
2022-11-05 00:00:00+00:00,-4.87,52871.64,2022-11,finances
2022-11-05 00:00:00+00:00,-7.99,52879.63,2022-11,shopping
2022-11-05 00:00:00+00:00,-23.15,52902.78,2022-11,transfer
2022-11-05 00:00:00+00:00,-12.73,52915.51,2022-11,finances
2022-11-05 00:00:00+00:00,-15.12,52930.63,2022-11,groceries / food spend
2022-11-05 00:00:00+00:00,-40.36,52970.99,2022-11,shopping
2022-11-04 00:00:00+00:00,6.82,52964.17,2022-11,transfer
2022-11-04 00:00:00+00:00,70.0,52894.17,2022-11,transfer
2022-11-04 00:00:00+00:00,59.17,52835.0,2022-11,transfer
2022-11-04 00:00:00+00:00,-20.0,52855.0,2022-11,transfer
2022-11-04 00:00:00+00:00,-13.05,52868.05,2022-11,shopping
2022-11-04 00:00:00+00:00,-3.47,52871.52,2022-11,finances
2022-11-04 00:00:00+00:00,-98.27,52969.79,2022-11,transfer
2022-11-04 00:00:00+00:00,100.0,52869.79,2022-11,transfer
2022-11-04 00:00:00+00:00,-3.59,52873.38,2022-11,business services
2022-11-04 00:00:00+00:00,5.38,52868.0,2022-11,transfer
2022-11-04 00:00:00+00:00,-130.0,52998.0,2022-11,rent
2022-11-03 00:00:00+00:00,0.89,52997.11,2022-11,transfer
2022-11-03 00:00:00+00:00,-0.41,52997.52,2022-11,savings
2022-11-03 00:00:00+00:00,130.0,52867.52,2022-11,transfer
2022-11-03 00:00:00+00:00,14.03,52853.49,2022-11,transfer
2022-11-03 00:00:00+00:00,-26.31,52879.8,2022-11,transport
2022-11-03 00:00:00+00:00,106.0,52773.8,2022-11,entertainment
2022-11-03 00:00:00+00:00,-0.01,52773.81,2022-11,savings
2022-11-03 00:00:00+00:00,-2.99,52776.8,2022-11,entertainment
2022-11-03 00:00:00+00:00,-21.8,52798.6,2022-11,shopping
2022-11-03 00:00:00+00:00,40.0,52758.6,2022-11,transfer
2022-11-03 00:00:00+00:00,-6.4,52765.0,2022-11,transfer
2022-11-03 00:00:00+00:00,-6.31,52771.31,2022-11,groceries / food spend
2022-11-02 00:00:00+00:00,30.0,52741.31,2022-11,transfer
2022-11-02 00:00:00+00:00,-30.0,52771.31,2022-11,transfer
2022-11-02 00:00:00+00:00,10.66,52760.65,2022-11,transfer
2022-11-02 00:00:00+00:00,-0.63,52761.28,2022-11,savings
2022-11-01 00:00:00+00:00,-50.84,52812.12,2022-11,bills and utilities
2022-11-01 00:00:00+00:00,-0.01,52812.13,2022-11,fees and charges
2022-11-01 00:00:00+00:00,-227.0,53039.13,2022-11,transfer
2022-11-01 00:00:00+00:00,-18.52,53057.65,2022-11,groceries / food spend
2022-11-01 00:00:00+00:00,-0.01,53057.66,2022-11,finances
2022-11-01 00:00:00+00:00,-0.01,53057.67,2022-11,shopping
2022-11-01 00:00:00+00:00,-0.0,53057.67,2022-11,shopping
2022-11-01 00:00:00+00:00,-0.01,53057.68,2022-11,groceries / food spend
2022-11-01 00:00:00+00:00,-0.0,53057.68,2022-11,groceries / food spend
2022-11-01 00:00:00+00:00,-0.02,53057.7,2022-11,groceries / food spend
2022-11-01 00:00:00+00:00,-0.01,53057.71,2022-11,groceries / food spend
2022-11-01 00:00:00+00:00,-0.01,53057.72,2022-11,transport
2022-11-01 00:00:00+00:00,-193.34,53251.06,2022-11,restaurants / eating out / delivery
2022-11-01 00:00:00+00:00,-0.01,53251.07,2022-11,home and garden
2022-11-01 00:00:00+00:00,-0.01,53251.08,2022-11,fees and charges
2022-11-01 00:00:00+00:00,-0.01,53251.09,2022-11,transport
2022-11-01 00:00:00+00:00,-0.01,53251.1,2022-11,entertainment
2022-11-01 00:00:00+00:00,-0.01,53251.11,2022-11,fees and charges
2022-11-01 00:00:00+00:00,-41.74,53292.85,2022-11,groceries / food spend
2022-11-01 00:00:00+00:00,-20.91,53313.76,2022-11,transfer
2022-11-01 00:00:00+00:00,-9.98,53323.74,2022-11,business services
2022-11-01 00:00:00+00:00,-9.71,53333.45,2022-11,bills and utilities
2022-11-01 00:00:00+00:00,-10.0,53343.45,2022-11,finances
2022-11-01 00:00:00+00:00,-10.0,53353.45,2022-11,finances
2022-11-01 00:00:00+00:00,-10.0,53363.45,2022-11,bills and utilities
2022-10-28 00:00:00+00:00,473.34,52890.11,2022-10,transfer
2022-10-28 00:00:00+00:00,-36.59,52926.7,2022-10,shopping
2022-10-28 00:00:00+00:00,15.72,52910.98,2022-10,transfer
2022-10-28 00:00:00+00:00,-32.72,52943.7,2022-10,transfer
2022-10-28 00:00:00+00:00,22.42,52921.28,2022-10,taxes
2022-10-27 00:00:00+00:00,-1.81,52923.09,2022-10,transfer
2022-10-27 00:00:00+00:00,50.59,52872.5,2022-10,transfer
2022-10-27 00:00:00+00:00,0.77,52871.73,2022-10,transfer
2022-10-27 00:00:00+00:00,-20.56,52892.29,2022-10,transport
2022-10-27 00:00:00+00:00,-3.09,52895.38,2022-10,finances
2022-10-27 00:00:00+00:00,-23.62,52919.0,2022-10,groceries / food spend
2022-10-27 00:00:00+00:00,-13.93,52932.93,2022-10,shopping
2022-10-25 00:00:00+00:00,70.0,52862.93,2022-10,transfer
2022-10-25 00:00:00+00:00,-55.45,52918.38,2022-10,entertainment
2022-10-25 00:00:00+00:00,-5.45,52923.83,2022-10,transfer
2022-10-25 00:00:00+00:00,-0.41,52924.24,2022-10,savings
2022-10-25 00:00:00+00:00,-36.59,52960.83,2022-10,shopping
2022-10-25 00:00:00+00:00,-0.5,52961.33,2022-10,savings
2022-10-25 00:00:00+00:00,-4.7,52966.03,2022-10,entertainment
2022-10-23 00:00:00+00:00,-26.79,52992.82,2022-10,finances
2022-10-23 00:00:00+00:00,32.63,52960.19,2022-10,transfer
2022-10-23 00:00:00+00:00,-117.63,53077.82,2022-10,transfer
2022-10-23 00:00:00+00:00,-1.51,53079.33,2022-10,savings
2022-10-23 00:00:00+00:00,-20.0,53099.33,2022-10,transfer
2022-10-22 00:00:00+00:00,-6.02,53105.35,2022-10,shopping
2022-10-22 00:00:00+00:00,-0.01,53105.36,2022-10,savings
2022-10-22 00:00:00+00:00,-39.25,53144.61,2022-10,bills and utilities
2022-10-22 00:00:00+00:00,-17.94,53162.55,2022-10,shopping
2022-10-22 00:00:00+00:00,-36.59,53199.14,2022-10,finances
2022-10-20 00:00:00+00:00,-150.0,53349.14,2022-10,rent
2022-10-20 00:00:00+00:00,22.42,53326.72,2022-10,taxes
2022-10-20 00:00:00+00:00,-550.0,53876.72,2022-10,business services
2022-10-20 00:00:00+00:00,345.13,53531.59,2022-10,taxes
2022-10-19 00:00:00+00:00,-7.99,53539.58,2022-10,shopping
2022-10-19 00:00:00+00:00,1450.42,52089.16,2022-10,salary
2022-10-18 00:00:00+00:00,82.21,52006.95,2022-10,finances
2022-10-17 00:00:00+00:00,77.77,51929.18,2022-10,transfer
2022-10-17 00:00:00+00:00,-12.73,51941.91,2022-10,finances
2022-10-17 00:00:00+00:00,-40.59,51982.5,2022-10,finances
2022-10-17 00:00:00+00:00,-22.95,52005.45,2022-10,transport
2022-10-17 00:00:00+00:00,-0.7,52006.15,2022-10,savings
2022-10-17 00:00:00+00:00,-6.37,52012.52,2022-10,groceries / food spend
2022-10-15 00:00:00+00:00,25.3,51987.22,2022-10,groceries / food spend
2022-10-15 00:00:00+00:00,-0.57,51987.79,2022-10,savings
2022-10-15 00:00:00+00:00,-15.45,52003.24,2022-10,shopping
2022-10-15 00:00:00+00:00,-0.5,52003.74,2022-10,savings
2022-10-15 00:00:00+00:00,-3.59,52007.33,2022-10,shopping
2022-10-15 00:00:00+00:00,-10.0,52017.33,2022-10,shopping
2022-10-14 00:00:00+00:00,-2.0,52019.33,2022-10,entertainment
2022-10-14 00:00:00+00:00,-20.5,52039.83,2022-10,entertainment
2022-10-14 00:00:00+00:00,-61.25,52101.08,2022-10,entertainment
2022-10-12 00:00:00+00:00,-0.38,52101.46,2022-10,savings
2022-10-12 00:00:00+00:00,-27.74,52129.2,2022-10,transport
2022-10-11 00:00:00+00:00,35.2,52094.0,2022-10,finances
2022-10-11 00:00:00+00:00,50.0,52044.0,2022-10,transfer
2022-10-11 00:00:00+00:00,22.42,52021.58,2022-10,taxes
2022-10-11 00:00:00+00:00,0.8,52020.78,2022-10,holidays
2022-10-10 00:00:00+00:00,-46.57,52067.35,2022-10,finances
2022-10-10 00:00:00+00:00,-5.0,52072.35,2022-10,groceries / food spend
2022-10-10 00:00:00+00:00,70.44,52001.91,2022-10,transfer
2022-10-10 00:00:00+00:00,50.36,51951.55,2022-10,finances
2022-10-10 00:00:00+00:00,-36.28,51987.83,2022-10,transfer
2022-10-10 00:00:00+00:00,-27.92,52015.75,2022-10,bills and utilities
2022-10-09 00:00:00+00:00,-23.62,52039.37,2022-10,transport
2022-10-09 00:00:00+00:00,-21.78,52061.15,2022-10,taxes
2022-10-09 00:00:00+00:00,-0.41,52061.56,2022-10,savings
2022-10-09 00:00:00+00:00,116.52,51945.04,2022-10,transfer
2022-10-08 00:00:00+00:00,-0.01,51945.05,2022-10,savings
2022-10-08 00:00:00+00:00,20.86,51924.19,2022-10,taxes
2022-10-08 00:00:00+00:00,-13.34,51937.53,2022-10,fees and charges
2022-10-08 00:00:00+00:00,-100.0,52037.53,2022-10,rent
2022-10-08 00:00:00+00:00,0.1,52037.43,2022-10,entertainment
2022-10-08 00:00:00+00:00,-0.69,52038.12,2022-10,savings
2022-10-08 00:00:00+00:00,-1.04,52039.16,2022-10,savings
2022-10-08 00:00:00+00:00,-24.31,52063.47,2022-10,groceries / food spend
2022-10-07 00:00:00+00:00,-77.38,52140.85,2022-10,bills and utilities
2022-10-07 00:00:00+00:00,-1.15,52142.0,2022-10,savings
2022-10-07 00:00:00+00:00,-80.91,52222.91,2022-10,transfer
2022-10-06 00:00:00+00:00,-27.96,52250.87,2022-10,bills and utilities
2022-10-06 00:00:00+00:00,20.52,52230.35,2022-10,taxes
2022-10-06 00:00:00+00:00,-12.89,52243.24,2022-10,groceries / food spend
2022-10-06 00:00:00+00:00,-45.92,52289.16,2022-10,bills and utilities
2022-10-06 00:00:00+00:00,-9.71,52298.87,2022-10,home and garden
2022-10-06 00:00:00+00:00,346.35,51952.52,2022-10,taxes
2022-10-06 00:00:00+00:00,137.6,51814.92,2022-10,transfer
2022-10-06 00:00:00+00:00,40.25,51774.67,2022-10,transfer
2022-10-06 00:00:00+00:00,-0.01,51774.68,2022-10,savings
2022-10-06 00:00:00+00:00,-2.84,51777.52,2022-10,shopping
2022-10-05 00:00:00+00:00,-60.0,51837.52,2022-10,transfer
2022-10-05 00:00:00+00:00,-2.0,51839.52,2022-10,savings
2022-10-05 00:00:00+00:00,-5.79,51845.31,2022-10,finances
2022-10-05 00:00:00+00:00,-7.99,51853.3,2022-10,shopping
2022-10-05 00:00:00+00:00,-23.15,51876.45,2022-10,transfer
2022-10-05 00:00:00+00:00,-12.73,51889.18,2022-10,finances
2022-10-05 00:00:00+00:00,-5.43,51894.61,2022-10,groceries / food spend
2022-10-05 00:00:00+00:00,-8.3,51902.91,2022-10,shopping
2022-10-04 00:00:00+00:00,17.18,51885.73,2022-10,transfer
2022-10-04 00:00:00+00:00,77.65,51808.08,2022-10,transfer
2022-10-04 00:00:00+00:00,46.77,51761.31,2022-10,transfer
2022-10-04 00:00:00+00:00,-10.96,51772.27,2022-10,transfer
2022-10-04 00:00:00+00:00,-5.0,51777.27,2022-10,shopping
2022-10-04 00:00:00+00:00,-3.07,51780.34,2022-10,finances
2022-10-04 00:00:00+00:00,-100.0,51880.34,2022-10,transfer
2022-10-04 00:00:00+00:00,100.0,51780.34,2022-10,transfer
2022-10-04 00:00:00+00:00,-3.3,51783.64,2022-10,business services
2022-10-04 00:00:00+00:00,26.24,51757.4,2022-10,transfer
2022-10-04 00:00:00+00:00,-130.0,51887.4,2022-10,rent
2022-10-03 00:00:00+00:00,0.64,51886.76,2022-10,transfer
2022-10-03 00:00:00+00:00,-0.41,51887.17,2022-10,savings
2022-10-03 00:00:00+00:00,130.0,51757.17,2022-10,transfer
2022-10-03 00:00:00+00:00,7.0,51750.17,2022-10,transfer
2022-10-03 00:00:00+00:00,-23.11,51773.28,2022-10,transport
2022-10-03 00:00:00+00:00,40.9,51732.38,2022-10,entertainment
2022-10-03 00:00:00+00:00,-0.01,51732.39,2022-10,savings
2022-10-03 00:00:00+00:00,-0.03,51732.42,2022-10,entertainment
2022-10-03 00:00:00+00:00,-8.84,51741.26,2022-10,shopping
2022-10-03 00:00:00+00:00,40.0,51701.26,2022-10,transfer
2022-10-03 00:00:00+00:00,-40.0,51741.26,2022-10,transfer
2022-10-03 00:00:00+00:00,-5.0,51746.26,2022-10,groceries / food spend
2022-10-02 00:00:00+00:00,29.51,51716.75,2022-10,transfer
2022-10-02 00:00:00+00:00,-44.69,51761.44,2022-10,transfer
2022-10-02 00:00:00+00:00,10.0,51751.44,2022-10,transfer
2022-10-02 00:00:00+00:00,-0.55,51751.99,2022-10,savings
2022-10-01 00:00:00+00:00,-46.82,51798.81,2022-10,bills and utilities
2022-10-01 00:00:00+00:00,-0.01,51798.82,2022-10,fees and charges
2022-10-01 00:00:00+00:00,-313.01,52111.83,2022-10,transfer
2022-10-01 00:00:00+00:00,-6.2,52118.03,2022-10,groceries / food spend
2022-10-01 00:00:00+00:00,-0.01,52118.04,2022-10,finances
2022-10-01 00:00:00+00:00,-0.01,52118.05,2022-10,shopping
2022-10-01 00:00:00+00:00,-0.02,52118.07,2022-10,shopping
2022-10-01 00:00:00+00:00,-0.01,52118.08,2022-10,groceries / food spend
2022-10-01 00:00:00+00:00,0.01,52118.07,2022-10,groceries / food spend
2022-10-01 00:00:00+00:00,-0.01,52118.08,2022-10,groceries / food spend
2022-10-01 00:00:00+00:00,-0.01,52118.09,2022-10,groceries / food spend
2022-10-01 00:00:00+00:00,-0.01,52118.1,2022-10,transport
2022-10-01 00:00:00+00:00,-187.8,52305.9,2022-10,restaurants / eating out / delivery
2022-10-01 00:00:00+00:00,-0.0,52305.9,2022-10,home and garden
2022-10-01 00:00:00+00:00,-0.01,52305.91,2022-10,fees and charges
2022-10-01 00:00:00+00:00,-0.01,52305.92,2022-10,transport
2022-10-01 00:00:00+00:00,-0.01,52305.93,2022-10,entertainment
2022-10-01 00:00:00+00:00,-0.01,52305.94,2022-10,fees and charges
2022-10-01 00:00:00+00:00,-23.99,52329.93,2022-10,groceries / food spend
2022-10-01 00:00:00+00:00,-13.68,52343.61,2022-10,transfer
2022-10-01 00:00:00+00:00,-0.61,52344.22,2022-10,business services
2022-10-01 00:00:00+00:00,-10.0,52354.22,2022-10,bills and utilities
2022-10-01 00:00:00+00:00,-11.55,52365.77,2022-10,finances
2022-10-01 00:00:00+00:00,-10.0,52375.77,2022-10,finances
2022-10-01 00:00:00+00:00,-10.0,52385.77,2022-10,bills and utilities
2022-09-28 00:00:00+00:00,420.0,51965.77,2022-09,transfer
2022-09-28 00:00:00+00:00,-36.59,52002.36,2022-09,shopping
2022-09-28 00:00:00+00:00,40.0,51962.36,2022-09,transfer
2022-09-28 00:00:00+00:00,-67.88,52030.24,2022-09,transfer
2022-09-28 00:00:00+00:00,20.87,52009.37,2022-09,taxes
2022-09-27 00:00:00+00:00,-7.93,52017.3,2022-09,transfer
2022-09-27 00:00:00+00:00,92.93,51924.37,2022-09,transfer
2022-09-27 00:00:00+00:00,15.86,51908.51,2022-09,transfer
2022-09-27 00:00:00+00:00,-15.43,51923.94,2022-09,transport
2022-09-27 00:00:00+00:00,-2.99,51926.93,2022-09,finances
2022-09-27 00:00:00+00:00,-23.62,51950.55,2022-09,groceries / food spend
2022-09-27 00:00:00+00:00,-7.56,51958.11,2022-09,shopping
2022-09-25 00:00:00+00:00,70.0,51888.11,2022-09,transfer
2022-09-25 00:00:00+00:00,-24.5,51912.61,2022-09,entertainment
2022-09-25 00:00:00+00:00,-6.39,51919.0,2022-09,transfer
2022-09-25 00:00:00+00:00,-0.43,51919.43,2022-09,savings
2022-09-25 00:00:00+00:00,-36.59,51956.02,2022-09,shopping
2022-09-25 00:00:00+00:00,-0.48,51956.5,2022-09,savings
2022-09-25 00:00:00+00:00,-18.99,51975.49,2022-09,entertainment
2022-09-23 00:00:00+00:00,-18.85,51994.34,2022-09,finances
2022-09-23 00:00:00+00:00,32.5,51961.84,2022-09,transfer
2022-09-23 00:00:00+00:00,-100.0,52061.84,2022-09,transfer
2022-09-23 00:00:00+00:00,-1.66,52063.5,2022-09,savings
2022-09-23 00:00:00+00:00,-20.0,52083.5,2022-09,transfer
2022-09-22 00:00:00+00:00,-5.0,52088.5,2022-09,shopping
2022-09-22 00:00:00+00:00,-0.01,52088.51,2022-09,savings
2022-09-22 00:00:00+00:00,-39.25,52127.76,2022-09,bills and utilities
2022-09-22 00:00:00+00:00,-12.12,52139.88,2022-09,shopping
2022-09-22 00:00:00+00:00,-36.59,52176.47,2022-09,finances
2022-09-20 00:00:00+00:00,-150.0,52326.47,2022-09,rent
2022-09-20 00:00:00+00:00,22.42,52304.05,2022-09,taxes
2022-09-20 00:00:00+00:00,-550.0,52854.05,2022-09,business services
2022-09-20 00:00:00+00:00,350.75,52503.3,2022-09,taxes
2022-09-19 00:00:00+00:00,-3.01,52506.31,2022-09,shopping
2022-09-19 00:00:00+00:00,1450.42,51055.89,2022-09,salary
2022-09-18 00:00:00+00:00,117.0,50938.89,2022-09,finances
2022-09-17 00:00:00+00:00,137.6,50801.29,2022-09,transfer
2022-09-17 00:00:00+00:00,-10.47,50811.76,2022-09,finances
2022-09-17 00:00:00+00:00,-40.0,50851.76,2022-09,finances
2022-09-17 00:00:00+00:00,-20.0,50871.76,2022-09,transport
2022-09-17 00:00:00+00:00,-0.59,50872.35,2022-09,savings
2022-09-17 00:00:00+00:00,-3.86,50876.21,2022-09,groceries / food spend
2022-09-15 00:00:00+00:00,-32.0,50908.21,2022-09,groceries / food spend
2022-09-15 00:00:00+00:00,-0.55,50908.76,2022-09,savings
2022-09-15 00:00:00+00:00,-23.75,50932.51,2022-09,shopping
2022-09-15 00:00:00+00:00,-0.52,50933.03,2022-09,savings
2022-09-15 00:00:00+00:00,-3.59,50936.62,2022-09,shopping
2022-09-15 00:00:00+00:00,-10.0,50946.62,2022-09,shopping
2022-09-14 00:00:00+00:00,-1.13,50947.75,2022-09,entertainment
2022-09-14 00:00:00+00:00,-10.25,50958.0,2022-09,entertainment
2022-09-14 00:00:00+00:00,50.18,50907.82,2022-09,entertainment
2022-09-12 00:00:00+00:00,-0.45,50908.27,2022-09,savings
2022-09-12 00:00:00+00:00,-23.11,50931.38,2022-09,transport
2022-09-11 00:00:00+00:00,50.0,50881.38,2022-09,finances
2022-09-11 00:00:00+00:00,52.1,50829.28,2022-09,transfer
2022-09-11 00:00:00+00:00,22.42,50806.86,2022-09,taxes
2022-09-11 00:00:00+00:00,-7.95,50814.81,2022-09,holidays
2022-09-10 00:00:00+00:00,-40.0,50854.81,2022-09,finances
2022-09-10 00:00:00+00:00,-2.07,50856.88,2022-09,groceries / food spend
2022-09-10 00:00:00+00:00,40.0,50816.88,2022-09,transfer
2022-09-10 00:00:00+00:00,50.36,50766.52,2022-09,finances
2022-09-10 00:00:00+00:00,-30.0,50796.52,2022-09,transfer
2022-09-10 00:00:00+00:00,-24.5,50821.02,2022-09,bills and utilities
2022-09-09 00:00:00+00:00,-17.16,50838.18,2022-09,transport
2022-09-09 00:00:00+00:00,-20.85,50859.03,2022-09,taxes
2022-09-09 00:00:00+00:00,-0.41,50859.44,2022-09,savings
2022-09-09 00:00:00+00:00,70.0,50789.44,2022-09,transfer
2022-09-08 00:00:00+00:00,-0.01,50789.45,2022-09,savings
2022-09-08 00:00:00+00:00,22.94,50766.51,2022-09,taxes
2022-09-08 00:00:00+00:00,-14.99,50781.5,2022-09,fees and charges
2022-09-08 00:00:00+00:00,-100.0,50881.5,2022-09,rent
2022-09-08 00:00:00+00:00,-10.0,50891.5,2022-09,entertainment
2022-09-08 00:00:00+00:00,-0.69,50892.19,2022-09,savings
2022-09-08 00:00:00+00:00,-1.2,50893.39,2022-09,savings
2022-09-08 00:00:00+00:00,-22.02,50915.41,2022-09,groceries / food spend
2022-09-07 00:00:00+00:00,-77.25,50992.66,2022-09,bills and utilities
2022-09-07 00:00:00+00:00,-1.15,50993.81,2022-09,savings
2022-09-07 00:00:00+00:00,-70.0,51063.81,2022-09,transfer
2022-09-06 00:00:00+00:00,-30.09,51093.9,2022-09,bills and utilities
2022-09-06 00:00:00+00:00,21.01,51072.89,2022-09,taxes
2022-09-06 00:00:00+00:00,-12.89,51085.78,2022-09,groceries / food spend
2022-09-06 00:00:00+00:00,-46.6,51132.38,2022-09,bills and utilities
2022-09-06 00:00:00+00:00,-9.71,51142.09,2022-09,home and garden
2022-09-06 00:00:00+00:00,324.3,50817.79,2022-09,taxes
2022-09-06 00:00:00+00:00,137.6,50680.19,2022-09,transfer
2022-09-06 00:00:00+00:00,90.93,50589.26,2022-09,transfer
2022-09-06 00:00:00+00:00,-0.01,50589.27,2022-09,savings
2022-09-06 00:00:00+00:00,-5.0,50594.27,2022-09,shopping
2022-09-05 00:00:00+00:00,-84.82,50679.09,2022-09,transfer
2022-09-05 00:00:00+00:00,-1.6,50680.69,2022-09,savings
2022-09-05 00:00:00+00:00,-5.79,50686.48,2022-09,finances
2022-09-05 00:00:00+00:00,-13.31,50699.79,2022-09,shopping
2022-09-05 00:00:00+00:00,-23.15,50722.94,2022-09,transfer
2022-09-05 00:00:00+00:00,-12.73,50735.67,2022-09,finances
2022-09-05 00:00:00+00:00,-15.81,50751.48,2022-09,groceries / food spend
2022-09-05 00:00:00+00:00,-27.06,50778.54,2022-09,shopping
2022-09-04 00:00:00+00:00,16.99,50761.55,2022-09,transfer
2022-09-04 00:00:00+00:00,70.0,50691.55,2022-09,transfer
2022-09-04 00:00:00+00:00,103.88,50587.67,2022-09,transfer
2022-09-04 00:00:00+00:00,-14.45,50602.12,2022-09,transfer
2022-09-04 00:00:00+00:00,-5.0,50607.12,2022-09,shopping
2022-09-04 00:00:00+00:00,-3.07,50610.19,2022-09,finances
2022-09-04 00:00:00+00:00,-100.0,50710.19,2022-09,transfer
2022-09-04 00:00:00+00:00,100.0,50610.19,2022-09,transfer
2022-09-04 00:00:00+00:00,-1.23,50611.42,2022-09,business services
2022-09-04 00:00:00+00:00,25.0,50586.42,2022-09,transfer
2022-09-04 00:00:00+00:00,-130.0,50716.42,2022-09,rent
2022-09-03 00:00:00+00:00,0.89,50715.53,2022-09,transfer
2022-09-03 00:00:00+00:00,-0.41,50715.94,2022-09,savings
2022-09-03 00:00:00+00:00,130.0,50585.94,2022-09,transfer
2022-09-03 00:00:00+00:00,7.0,50578.94,2022-09,transfer
2022-09-03 00:00:00+00:00,-33.73,50612.67,2022-09,transport
2022-09-03 00:00:00+00:00,65.09,50547.58,2022-09,entertainment
2022-09-03 00:00:00+00:00,-0.01,50547.59,2022-09,savings
2022-09-03 00:00:00+00:00,-0.06,50547.65,2022-09,entertainment
2022-09-03 00:00:00+00:00,-30.0,50577.65,2022-09,shopping
2022-09-03 00:00:00+00:00,59.99,50517.66,2022-09,transfer
2022-09-03 00:00:00+00:00,-40.0,50557.66,2022-09,transfer
2022-09-03 00:00:00+00:00,-5.0,50562.66,2022-09,groceries / food spend
2022-09-02 00:00:00+00:00,30.0,50532.66,2022-09,transfer
2022-09-02 00:00:00+00:00,-30.0,50562.66,2022-09,transfer
2022-09-02 00:00:00+00:00,10.0,50552.66,2022-09,transfer
2022-09-02 00:00:00+00:00,-0.58,50553.24,2022-09,savings
2022-09-01 00:00:00+00:00,-46.82,50600.06,2022-09,bills and utilities
2022-09-01 00:00:00+00:00,-0.01,50600.07,2022-09,fees and charges
2022-09-01 00:00:00+00:00,-212.79,50812.86,2022-09,transfer
2022-09-01 00:00:00+00:00,-51.15,50864.01,2022-09,groceries / food spend
2022-09-01 00:00:00+00:00,-0.01,50864.02,2022-09,finances
2022-09-01 00:00:00+00:00,-0.01,50864.03,2022-09,shopping
2022-09-01 00:00:00+00:00,-0.02,50864.05,2022-09,shopping
2022-09-01 00:00:00+00:00,-0.01,50864.06,2022-09,groceries / food spend
2022-09-01 00:00:00+00:00,-0.01,50864.07,2022-09,groceries / food spend
2022-09-01 00:00:00+00:00,0.0,50864.07,2022-09,groceries / food spend
2022-09-01 00:00:00+00:00,-0.01,50864.08,2022-09,groceries / food spend
2022-09-01 00:00:00+00:00,-0.01,50864.09,2022-09,transport
2022-09-01 00:00:00+00:00,-351.14,51215.23,2022-09,restaurants / eating out / delivery
2022-09-01 00:00:00+00:00,-0.01,51215.24,2022-09,home and garden
2022-09-01 00:00:00+00:00,-0.01,51215.25,2022-09,fees and charges
2022-09-01 00:00:00+00:00,-0.01,51215.26,2022-09,transport
2022-09-01 00:00:00+00:00,-0.01,51215.27,2022-09,entertainment
2022-09-01 00:00:00+00:00,-0.02,51215.29,2022-09,fees and charges
2022-09-01 00:00:00+00:00,-23.99,51239.28,2022-09,groceries / food spend
2022-09-01 00:00:00+00:00,-20.91,51260.19,2022-09,transfer
2022-09-01 00:00:00+00:00,-10.0,51270.19,2022-09,business services
2022-09-01 00:00:00+00:00,-10.0,51280.19,2022-09,bills and utilities
2022-09-01 00:00:00+00:00,-9.54,51289.73,2022-09,finances
2022-09-01 00:00:00+00:00,-10.0,51299.73,2022-09,finances
2022-09-01 00:00:00+00:00,-10.0,51309.73,2022-09,bills and utilities
2022-08-28 00:00:00+00:00,420.0,50889.73,2022-08,transfer
2022-08-28 00:00:00+00:00,-36.59,50926.32,2022-08,shopping
2022-08-28 00:00:00+00:00,-4.69,50931.01,2022-08,transfer
2022-08-28 00:00:00+00:00,-32.72,50963.73,2022-08,transfer
2022-08-28 00:00:00+00:00,22.15,50941.58,2022-08,taxes
2022-08-27 00:00:00+00:00,-7.93,50949.51,2022-08,transfer
2022-08-27 00:00:00+00:00,50.59,50898.92,2022-08,transfer
2022-08-27 00:00:00+00:00,31.74,50867.18,2022-08,transfer
2022-08-27 00:00:00+00:00,-25.27,50892.45,2022-08,transport
2022-08-27 00:00:00+00:00,-2.99,50895.44,2022-08,finances
2022-08-27 00:00:00+00:00,-33.59,50929.03,2022-08,groceries / food spend
2022-08-27 00:00:00+00:00,-7.56,50936.59,2022-08,shopping
2022-08-25 00:00:00+00:00,70.0,50866.59,2022-08,transfer
2022-08-25 00:00:00+00:00,-24.5,50891.09,2022-08,entertainment
2022-08-25 00:00:00+00:00,-10.0,50901.09,2022-08,transfer
2022-08-25 00:00:00+00:00,-0.41,50901.5,2022-08,savings
2022-08-25 00:00:00+00:00,-46.57,50948.07,2022-08,shopping
2022-08-25 00:00:00+00:00,-0.5,50948.57,2022-08,savings
2022-08-25 00:00:00+00:00,-10.5,50959.07,2022-08,entertainment
2022-08-23 00:00:00+00:00,-37.83,50996.9,2022-08,finances
2022-08-23 00:00:00+00:00,34.12,50962.78,2022-08,transfer
2022-08-23 00:00:00+00:00,-100.0,51062.78,2022-08,transfer
2022-08-23 00:00:00+00:00,-1.57,51064.35,2022-08,savings
2022-08-23 00:00:00+00:00,-17.49,51081.84,2022-08,transfer
2022-08-22 00:00:00+00:00,-5.0,51086.84,2022-08,shopping
2022-08-22 00:00:00+00:00,-0.01,51086.85,2022-08,savings
2022-08-22 00:00:00+00:00,-39.25,51126.1,2022-08,bills and utilities
2022-08-22 00:00:00+00:00,-36.59,51162.69,2022-08,shopping
2022-08-22 00:00:00+00:00,-43.57,51206.26,2022-08,finances
2022-08-20 00:00:00+00:00,-150.0,51356.26,2022-08,rent
2022-08-20 00:00:00+00:00,22.42,51333.84,2022-08,taxes
2022-08-20 00:00:00+00:00,-661.23,51995.07,2022-08,business services
2022-08-20 00:00:00+00:00,354.27,51640.8,2022-08,taxes
2022-08-19 00:00:00+00:00,-7.99,51648.79,2022-08,shopping
2022-08-19 00:00:00+00:00,1450.42,50198.37,2022-08,salary
2022-08-18 00:00:00+00:00,57.2,50141.17,2022-08,finances
2022-08-17 00:00:00+00:00,137.6,50003.57,2022-08,transfer
2022-08-17 00:00:00+00:00,-12.73,50016.3,2022-08,finances
2022-08-17 00:00:00+00:00,-48.76,50065.06,2022-08,finances
2022-08-17 00:00:00+00:00,-20.0,50085.06,2022-08,transport
2022-08-17 00:00:00+00:00,-0.63,50085.69,2022-08,savings
2022-08-17 00:00:00+00:00,-1.76,50087.45,2022-08,groceries / food spend
2022-08-15 00:00:00+00:00,-32.0,50119.45,2022-08,groceries / food spend
2022-08-15 00:00:00+00:00,-0.58,50120.03,2022-08,savings
2022-08-15 00:00:00+00:00,-15.45,50135.48,2022-08,shopping
2022-08-15 00:00:00+00:00,-0.5,50135.98,2022-08,savings
2022-08-15 00:00:00+00:00,-0.84,50136.82,2022-08,shopping
2022-08-15 00:00:00+00:00,-10.0,50146.82,2022-08,shopping
2022-08-14 00:00:00+00:00,-2.0,50148.82,2022-08,entertainment
2022-08-14 00:00:00+00:00,-20.5,50169.32,2022-08,entertainment
2022-08-14 00:00:00+00:00,47.34,50121.98,2022-08,entertainment
2022-08-12 00:00:00+00:00,-0.41,50122.39,2022-08,savings
2022-08-12 00:00:00+00:00,-23.11,50145.5,2022-08,transport
2022-08-11 00:00:00+00:00,37.46,50108.04,2022-08,finances
2022-08-11 00:00:00+00:00,51.09,50056.95,2022-08,transfer
2022-08-11 00:00:00+00:00,23.07,50033.88,2022-08,taxes
2022-08-11 00:00:00+00:00,-25.78,50059.66,2022-08,holidays
2022-08-10 00:00:00+00:00,-35.43,50095.09,2022-08,finances
2022-08-10 00:00:00+00:00,-5.0,50100.09,2022-08,groceries / food spend
2022-08-10 00:00:00+00:00,14.95,50085.14,2022-08,transfer
2022-08-10 00:00:00+00:00,55.43,50029.71,2022-08,finances
2022-08-10 00:00:00+00:00,-30.0,50059.71,2022-08,transfer
2022-08-10 00:00:00+00:00,-26.59,50086.3,2022-08,bills and utilities
2022-08-09 00:00:00+00:00,-23.62,50109.92,2022-08,transport
2022-08-09 00:00:00+00:00,-20.56,50130.48,2022-08,taxes
2022-08-09 00:00:00+00:00,-0.36,50130.84,2022-08,savings
2022-08-09 00:00:00+00:00,70.0,50060.84,2022-08,transfer
2022-08-08 00:00:00+00:00,-0.01,50060.85,2022-08,savings
2022-08-08 00:00:00+00:00,22.42,50038.43,2022-08,taxes
2022-08-08 00:00:00+00:00,-14.99,50053.42,2022-08,fees and charges
2022-08-08 00:00:00+00:00,-100.0,50153.42,2022-08,rent
2022-08-08 00:00:00+00:00,-10.0,50163.42,2022-08,entertainment
2022-08-08 00:00:00+00:00,-0.69,50164.11,2022-08,savings
2022-08-08 00:00:00+00:00,-1.16,50165.27,2022-08,savings
2022-08-08 00:00:00+00:00,-56.1,50221.37,2022-08,groceries / food spend
2022-08-07 00:00:00+00:00,-82.37,50303.74,2022-08,bills and utilities
2022-08-07 00:00:00+00:00,-1.15,50304.89,2022-08,savings
2022-08-07 00:00:00+00:00,-52.43,50357.32,2022-08,transfer
2022-08-06 00:00:00+00:00,-24.98,50382.3,2022-08,bills and utilities
2022-08-06 00:00:00+00:00,22.42,50359.88,2022-08,taxes
2022-08-06 00:00:00+00:00,-12.89,50372.77,2022-08,groceries / food spend
2022-08-06 00:00:00+00:00,-44.47,50417.24,2022-08,bills and utilities
2022-08-06 00:00:00+00:00,0.63,50416.61,2022-08,home and garden
2022-08-06 00:00:00+00:00,346.35,50070.26,2022-08,taxes
2022-08-06 00:00:00+00:00,-5.07,50075.33,2022-08,transfer
2022-08-06 00:00:00+00:00,61.89,50013.44,2022-08,transfer
2022-08-06 00:00:00+00:00,-0.01,50013.45,2022-08,savings
2022-08-06 00:00:00+00:00,-5.0,50018.45,2022-08,shopping
2022-08-05 00:00:00+00:00,-116.84,50135.29,2022-08,transfer
2022-08-05 00:00:00+00:00,-1.89,50137.18,2022-08,savings
2022-08-05 00:00:00+00:00,-5.79,50142.97,2022-08,finances
2022-08-05 00:00:00+00:00,-7.99,50150.96,2022-08,shopping
2022-08-05 00:00:00+00:00,-24.54,50175.5,2022-08,transfer
2022-08-05 00:00:00+00:00,-12.73,50188.23,2022-08,finances
2022-08-05 00:00:00+00:00,-6.37,50194.6,2022-08,groceries / food spend
2022-08-05 00:00:00+00:00,-20.0,50214.6,2022-08,shopping
2022-08-04 00:00:00+00:00,10.0,50204.6,2022-08,transfer
2022-08-04 00:00:00+00:00,59.49,50145.11,2022-08,transfer
2022-08-04 00:00:00+00:00,59.17,50085.94,2022-08,transfer
2022-08-04 00:00:00+00:00,-20.0,50105.94,2022-08,transfer
2022-08-04 00:00:00+00:00,-5.0,50110.94,2022-08,shopping
2022-08-04 00:00:00+00:00,-3.12,50114.06,2022-08,finances
2022-08-04 00:00:00+00:00,-59.03,50173.09,2022-08,transfer
2022-08-04 00:00:00+00:00,97.68,50075.41,2022-08,transfer
2022-08-04 00:00:00+00:00,-3.59,50079.0,2022-08,business services
2022-08-04 00:00:00+00:00,25.0,50054.0,2022-08,transfer
2022-08-04 00:00:00+00:00,-130.0,50184.0,2022-08,rent
2022-08-03 00:00:00+00:00,0.89,50183.11,2022-08,transfer
2022-08-03 00:00:00+00:00,-0.46,50183.57,2022-08,savings
2022-08-03 00:00:00+00:00,130.0,50053.57,2022-08,transfer
2022-08-03 00:00:00+00:00,2.73,50050.84,2022-08,transfer
2022-08-03 00:00:00+00:00,-23.11,50073.95,2022-08,transport
2022-08-03 00:00:00+00:00,75.63,49998.32,2022-08,entertainment
2022-08-03 00:00:00+00:00,-0.01,49998.33,2022-08,savings
2022-08-03 00:00:00+00:00,-2.99,50001.32,2022-08,entertainment
2022-08-03 00:00:00+00:00,-22.81,50024.13,2022-08,shopping
2022-08-03 00:00:00+00:00,40.0,49984.13,2022-08,transfer
2022-08-03 00:00:00+00:00,-40.0,50024.13,2022-08,transfer
2022-08-03 00:00:00+00:00,-8.34,50032.47,2022-08,groceries / food spend
2022-08-02 00:00:00+00:00,30.0,50002.47,2022-08,transfer
2022-08-02 00:00:00+00:00,-30.0,50032.47,2022-08,transfer
2022-08-02 00:00:00+00:00,10.82,50021.65,2022-08,transfer
2022-08-02 00:00:00+00:00,-0.64,50022.29,2022-08,savings
2022-08-01 00:00:00+00:00,-49.9,50072.19,2022-08,bills and utilities
2022-08-01 00:00:00+00:00,-0.01,50072.2,2022-08,fees and charges
2022-08-01 00:00:00+00:00,-227.0,50299.2,2022-08,transfer
2022-08-01 00:00:00+00:00,-11.86,50311.06,2022-08,groceries / food spend
2022-08-01 00:00:00+00:00,-0.01,50311.07,2022-08,finances
2022-08-01 00:00:00+00:00,-0.01,50311.08,2022-08,shopping
2022-08-01 00:00:00+00:00,-0.01,50311.09,2022-08,shopping
2022-08-01 00:00:00+00:00,-0.0,50311.09,2022-08,groceries / food spend
2022-08-01 00:00:00+00:00,-0.01,50311.1,2022-08,groceries / food spend
2022-08-01 00:00:00+00:00,-0.01,50311.11,2022-08,groceries / food spend
2022-08-01 00:00:00+00:00,-0.01,50311.12,2022-08,groceries / food spend
2022-08-01 00:00:00+00:00,-0.01,50311.13,2022-08,transport
2022-08-01 00:00:00+00:00,-200.0,50511.13,2022-08,restaurants / eating out / delivery
2022-08-01 00:00:00+00:00,-0.01,50511.14,2022-08,home and garden
2022-08-01 00:00:00+00:00,-0.01,50511.15,2022-08,fees and charges
2022-08-01 00:00:00+00:00,-0.01,50511.16,2022-08,transport
2022-08-01 00:00:00+00:00,-0.01,50511.17,2022-08,entertainment
2022-08-01 00:00:00+00:00,-0.01,50511.18,2022-08,fees and charges
2022-08-01 00:00:00+00:00,-23.99,50535.17,2022-08,groceries / food spend
2022-08-01 00:00:00+00:00,-20.91,50556.08,2022-08,transfer
2022-08-01 00:00:00+00:00,-10.0,50566.08,2022-08,business services
2022-08-01 00:00:00+00:00,-10.0,50576.08,2022-08,bills and utilities
2022-08-01 00:00:00+00:00,-10.08,50586.16,2022-08,finances
2022-08-01 00:00:00+00:00,-7.1,50593.26,2022-08,finances
2022-08-01 00:00:00+00:00,-9.93,50603.19,2022-08,bills and utilities
2022-07-28 00:00:00+00:00,137.89,50465.3,2022-07,transfer
2022-07-28 00:00:00+00:00,-36.59,50501.89,2022-07,shopping
2022-07-28 00:00:00+00:00,40.0,50461.89,2022-07,transfer
2022-07-28 00:00:00+00:00,-32.72,50494.61,2022-07,transfer
2022-07-28 00:00:00+00:00,22.42,50472.19,2022-07,taxes
2022-07-27 00:00:00+00:00,-3.8,50475.99,2022-07,transfer
2022-07-27 00:00:00+00:00,41.86,50434.13,2022-07,transfer
2022-07-27 00:00:00+00:00,11.26,50422.87,2022-07,transfer
2022-07-27 00:00:00+00:00,-20.56,50443.43,2022-07,transport
2022-07-27 00:00:00+00:00,-3.11,50446.54,2022-07,finances
2022-07-27 00:00:00+00:00,-36.01,50482.55,2022-07,groceries / food spend
2022-07-27 00:00:00+00:00,-10.36,50492.91,2022-07,shopping
2022-07-25 00:00:00+00:00,70.0,50422.91,2022-07,transfer
2022-07-25 00:00:00+00:00,-24.5,50447.41,2022-07,entertainment
2022-07-25 00:00:00+00:00,-4.81,50452.22,2022-07,transfer
2022-07-25 00:00:00+00:00,-0.34,50452.56,2022-07,savings
2022-07-25 00:00:00+00:00,-3.57,50456.13,2022-07,shopping
2022-07-25 00:00:00+00:00,-0.55,50456.68,2022-07,savings
2022-07-25 00:00:00+00:00,-30.41,50487.09,2022-07,entertainment
2022-07-23 00:00:00+00:00,-37.8,50524.89,2022-07,finances
2022-07-23 00:00:00+00:00,10.6,50514.29,2022-07,transfer
2022-07-23 00:00:00+00:00,-108.88,50623.17,2022-07,transfer
2022-07-23 00:00:00+00:00,-1.57,50624.74,2022-07,savings
2022-07-23 00:00:00+00:00,-20.0,50644.74,2022-07,transfer
2022-07-22 00:00:00+00:00,-7.85,50652.59,2022-07,shopping
2022-07-22 00:00:00+00:00,-0.01,50652.6,2022-07,savings
2022-07-22 00:00:00+00:00,-39.25,50691.85,2022-07,bills and utilities
2022-07-22 00:00:00+00:00,14.15,50677.7,2022-07,shopping
2022-07-22 00:00:00+00:00,-37.69,50715.39,2022-07,finances
2022-07-20 00:00:00+00:00,-150.0,50865.39,2022-07,rent
2022-07-20 00:00:00+00:00,22.42,50842.97,2022-07,taxes
2022-07-20 00:00:00+00:00,-591.88,51434.85,2022-07,business services
2022-07-20 00:00:00+00:00,371.2,51063.65,2022-07,taxes
2022-07-19 00:00:00+00:00,-7.99,51071.64,2022-07,shopping
2022-07-19 00:00:00+00:00,1450.42,49621.22,2022-07,salary
2022-07-18 00:00:00+00:00,82.21,49539.01,2022-07,finances
2022-07-17 00:00:00+00:00,45.22,49493.79,2022-07,transfer
2022-07-17 00:00:00+00:00,-12.73,49506.52,2022-07,finances
2022-07-17 00:00:00+00:00,-40.0,49546.52,2022-07,finances
2022-07-17 00:00:00+00:00,-20.0,49566.52,2022-07,transport
2022-07-17 00:00:00+00:00,-0.63,49567.15,2022-07,savings
2022-07-17 00:00:00+00:00,-6.37,49573.52,2022-07,groceries / food spend
2022-07-15 00:00:00+00:00,-56.18,49629.7,2022-07,groceries / food spend
2022-07-15 00:00:00+00:00,-0.57,49630.27,2022-07,savings
2022-07-15 00:00:00+00:00,-22.22,49652.49,2022-07,shopping
2022-07-15 00:00:00+00:00,-0.5,49652.99,2022-07,savings
2022-07-15 00:00:00+00:00,-3.59,49656.58,2022-07,shopping
2022-07-15 00:00:00+00:00,-9.03,49665.61,2022-07,shopping
2022-07-14 00:00:00+00:00,-2.0,49667.61,2022-07,entertainment
2022-07-14 00:00:00+00:00,-20.5,49688.11,2022-07,entertainment
2022-07-14 00:00:00+00:00,43.5,49644.61,2022-07,entertainment
2022-07-12 00:00:00+00:00,-0.41,49645.02,2022-07,savings
2022-07-12 00:00:00+00:00,-26.64,49671.66,2022-07,transport
2022-07-11 00:00:00+00:00,41.81,49629.85,2022-07,finances
2022-07-11 00:00:00+00:00,50.0,49579.85,2022-07,transfer
2022-07-11 00:00:00+00:00,22.42,49557.43,2022-07,taxes
2022-07-11 00:00:00+00:00,-17.0,49574.43,2022-07,holidays
2022-07-10 00:00:00+00:00,-40.0,49614.43,2022-07,finances
2022-07-10 00:00:00+00:00,-5.0,49619.43,2022-07,groceries / food spend
2022-07-10 00:00:00+00:00,40.13,49579.3,2022-07,transfer
2022-07-10 00:00:00+00:00,50.36,49528.94,2022-07,finances
2022-07-10 00:00:00+00:00,-15.85,49544.79,2022-07,transfer
2022-07-10 00:00:00+00:00,-24.5,49569.29,2022-07,bills and utilities
2022-07-09 00:00:00+00:00,-27.79,49597.08,2022-07,transport
2022-07-09 00:00:00+00:00,-20.56,49617.64,2022-07,taxes
2022-07-09 00:00:00+00:00,-0.41,49618.05,2022-07,savings
2022-07-09 00:00:00+00:00,70.0,49548.05,2022-07,transfer
2022-07-08 00:00:00+00:00,-0.01,49548.06,2022-07,savings
2022-07-08 00:00:00+00:00,23.49,49524.57,2022-07,taxes
2022-07-08 00:00:00+00:00,-20.14,49544.71,2022-07,fees and charges
2022-07-08 00:00:00+00:00,-100.0,49644.71,2022-07,rent
2022-07-08 00:00:00+00:00,-11.41,49656.12,2022-07,entertainment
2022-07-08 00:00:00+00:00,-0.69,49656.81,2022-07,savings
2022-07-08 00:00:00+00:00,-1.04,49657.85,2022-07,savings
2022-07-08 00:00:00+00:00,-24.31,49682.16,2022-07,groceries / food spend
2022-07-07 00:00:00+00:00,-78.96,49761.12,2022-07,bills and utilities
2022-07-07 00:00:00+00:00,-0.98,49762.1,2022-07,savings
2022-07-07 00:00:00+00:00,-70.0,49832.1,2022-07,transfer
2022-07-06 00:00:00+00:00,-28.25,49860.35,2022-07,bills and utilities
2022-07-06 00:00:00+00:00,22.42,49837.93,2022-07,taxes
2022-07-06 00:00:00+00:00,-12.89,49850.82,2022-07,groceries / food spend
2022-07-06 00:00:00+00:00,-50.0,49900.82,2022-07,bills and utilities
2022-07-06 00:00:00+00:00,-9.71,49910.53,2022-07,home and garden
2022-07-06 00:00:00+00:00,342.94,49567.59,2022-07,taxes
2022-07-06 00:00:00+00:00,137.6,49429.99,2022-07,transfer
2022-07-06 00:00:00+00:00,66.27,49363.72,2022-07,transfer
2022-07-06 00:00:00+00:00,-0.01,49363.73,2022-07,savings
2022-07-06 00:00:00+00:00,-5.0,49368.73,2022-07,shopping
2022-07-05 00:00:00+00:00,-152.12,49520.85,2022-07,transfer
2022-07-05 00:00:00+00:00,-1.89,49522.74,2022-07,savings
2022-07-05 00:00:00+00:00,-5.79,49528.53,2022-07,finances
2022-07-05 00:00:00+00:00,-17.08,49545.61,2022-07,shopping
2022-07-05 00:00:00+00:00,-23.15,49568.76,2022-07,transfer
2022-07-05 00:00:00+00:00,-14.18,49582.94,2022-07,finances
2022-07-05 00:00:00+00:00,-3.71,49586.65,2022-07,groceries / food spend
2022-07-05 00:00:00+00:00,-20.0,49606.65,2022-07,shopping
2022-07-04 00:00:00+00:00,18.56,49588.09,2022-07,transfer
2022-07-04 00:00:00+00:00,42.33,49545.76,2022-07,transfer
2022-07-04 00:00:00+00:00,59.17,49486.59,2022-07,transfer
2022-07-04 00:00:00+00:00,-20.0,49506.59,2022-07,transfer
2022-07-04 00:00:00+00:00,-1.52,49508.11,2022-07,shopping
2022-07-04 00:00:00+00:00,-1.49,49509.6,2022-07,finances
2022-07-04 00:00:00+00:00,-130.5,49640.1,2022-07,transfer
2022-07-04 00:00:00+00:00,100.0,49540.1,2022-07,transfer
2022-07-04 00:00:00+00:00,-3.59,49543.69,2022-07,business services
2022-07-04 00:00:00+00:00,25.0,49518.69,2022-07,transfer
2022-07-04 00:00:00+00:00,-130.0,49648.69,2022-07,rent
2022-07-03 00:00:00+00:00,0.94,49647.75,2022-07,transfer
2022-07-03 00:00:00+00:00,-0.44,49648.19,2022-07,savings
2022-07-03 00:00:00+00:00,130.0,49518.19,2022-07,transfer
2022-07-03 00:00:00+00:00,7.0,49511.19,2022-07,transfer
2022-07-03 00:00:00+00:00,-26.93,49538.12,2022-07,transport
2022-07-03 00:00:00+00:00,35.49,49502.63,2022-07,entertainment
2022-07-03 00:00:00+00:00,-0.01,49502.64,2022-07,savings
2022-07-03 00:00:00+00:00,-2.89,49505.53,2022-07,entertainment
2022-07-03 00:00:00+00:00,-16.36,49521.89,2022-07,shopping
2022-07-03 00:00:00+00:00,40.0,49481.89,2022-07,transfer
2022-07-03 00:00:00+00:00,-47.5,49529.39,2022-07,transfer
2022-07-03 00:00:00+00:00,-5.0,49534.39,2022-07,groceries / food spend
2022-07-02 00:00:00+00:00,30.0,49504.39,2022-07,transfer
2022-07-02 00:00:00+00:00,-30.0,49534.39,2022-07,transfer
2022-07-02 00:00:00+00:00,6.77,49527.62,2022-07,transfer
2022-07-02 00:00:00+00:00,-0.59,49528.21,2022-07,savings
2022-07-01 00:00:00+00:00,-59.52,49587.73,2022-07,bills and utilities
2022-07-01 00:00:00+00:00,-0.01,49587.74,2022-07,fees and charges
2022-07-01 00:00:00+00:00,-420.95,50008.69,2022-07,transfer
2022-07-01 00:00:00+00:00,-23.92,50032.61,2022-07,groceries / food spend
2022-07-01 00:00:00+00:00,-0.01,50032.62,2022-07,finances
2022-07-01 00:00:00+00:00,-0.01,50032.63,2022-07,shopping
2022-07-01 00:00:00+00:00,-0.01,50032.64,2022-07,shopping
2022-07-01 00:00:00+00:00,-0.0,50032.64,2022-07,groceries / food spend
2022-07-01 00:00:00+00:00,-0.0,50032.64,2022-07,groceries / food spend
2022-07-01 00:00:00+00:00,-0.01,50032.65,2022-07,groceries / food spend
2022-07-01 00:00:00+00:00,-0.03,50032.68,2022-07,groceries / food spend
2022-07-01 00:00:00+00:00,-0.01,50032.69,2022-07,transport
2022-07-01 00:00:00+00:00,-91.65,50124.34,2022-07,restaurants / eating out / delivery
2022-07-01 00:00:00+00:00,-0.01,50124.35,2022-07,home and garden
2022-07-01 00:00:00+00:00,-0.0,50124.35,2022-07,fees and charges
2022-07-01 00:00:00+00:00,-0.01,50124.36,2022-07,transport
2022-07-01 00:00:00+00:00,-0.01,50124.37,2022-07,entertainment
2022-07-01 00:00:00+00:00,-0.01,50124.38,2022-07,fees and charges
2022-07-01 00:00:00+00:00,-23.99,50148.37,2022-07,groceries / food spend
2022-07-01 00:00:00+00:00,-33.91,50182.28,2022-07,transfer
2022-07-01 00:00:00+00:00,-11.72,50194.0,2022-07,business services
2022-07-01 00:00:00+00:00,-9.3,50203.3,2022-07,bills and utilities
2022-07-01 00:00:00+00:00,-7.09,50210.39,2022-07,finances
2022-07-01 00:00:00+00:00,-10.0,50220.39,2022-07,finances
2022-07-01 00:00:00+00:00,-10.0,50230.39,2022-07,bills and utilities
2022-06-28 00:00:00+00:00,420.0,49810.39,2022-06,transfer
2022-06-28 00:00:00+00:00,-38.27,49848.66,2022-06,shopping
2022-06-28 00:00:00+00:00,40.0,49808.66,2022-06,transfer
2022-06-28 00:00:00+00:00,-32.72,49841.38,2022-06,transfer
2022-06-28 00:00:00+00:00,22.42,49818.96,2022-06,taxes
2022-06-27 00:00:00+00:00,-7.93,49826.89,2022-06,transfer
2022-06-27 00:00:00+00:00,50.59,49776.3,2022-06,transfer
2022-06-27 00:00:00+00:00,15.86,49760.44,2022-06,transfer
2022-06-27 00:00:00+00:00,-22.29,49782.73,2022-06,transport
2022-06-27 00:00:00+00:00,-2.21,49784.94,2022-06,finances
2022-06-27 00:00:00+00:00,-41.87,49826.81,2022-06,groceries / food spend
2022-06-27 00:00:00+00:00,-7.56,49834.37,2022-06,shopping
2022-06-25 00:00:00+00:00,6.75,49827.62,2022-06,transfer
2022-06-25 00:00:00+00:00,-53.16,49880.78,2022-06,entertainment
2022-06-25 00:00:00+00:00,-11.2,49891.98,2022-06,transfer
2022-06-25 00:00:00+00:00,-0.44,49892.42,2022-06,savings
2022-06-25 00:00:00+00:00,-55.11,49947.53,2022-06,shopping
2022-06-25 00:00:00+00:00,-0.48,49948.01,2022-06,savings
2022-06-25 00:00:00+00:00,-10.5,49958.51,2022-06,entertainment
2022-06-23 00:00:00+00:00,-30.0,49988.51,2022-06,finances
2022-06-23 00:00:00+00:00,34.4,49954.11,2022-06,transfer
2022-06-23 00:00:00+00:00,-100.0,50054.11,2022-06,transfer
2022-06-23 00:00:00+00:00,-1.35,50055.46,2022-06,savings
2022-06-23 00:00:00+00:00,-20.0,50075.46,2022-06,transfer
2022-06-22 00:00:00+00:00,-2.66,50078.12,2022-06,shopping
2022-06-22 00:00:00+00:00,-0.01,50078.13,2022-06,savings
2022-06-22 00:00:00+00:00,-36.38,50114.51,2022-06,bills and utilities
2022-06-22 00:00:00+00:00,-36.59,50151.1,2022-06,shopping
2022-06-22 00:00:00+00:00,-45.02,50196.12,2022-06,finances
2022-06-20 00:00:00+00:00,-150.0,50346.12,2022-06,rent
2022-06-20 00:00:00+00:00,22.42,50323.7,2022-06,taxes
2022-06-20 00:00:00+00:00,-550.0,50873.7,2022-06,business services
2022-06-20 00:00:00+00:00,345.13,50528.57,2022-06,taxes
2022-06-19 00:00:00+00:00,-7.99,50536.56,2022-06,shopping
2022-06-19 00:00:00+00:00,1450.42,49086.14,2022-06,salary
2022-06-18 00:00:00+00:00,84.18,49001.96,2022-06,finances
2022-06-17 00:00:00+00:00,137.6,48864.36,2022-06,transfer
2022-06-17 00:00:00+00:00,-12.73,48877.09,2022-06,finances
2022-06-17 00:00:00+00:00,-34.95,48912.04,2022-06,finances
2022-06-17 00:00:00+00:00,-21.16,48933.2,2022-06,transport
2022-06-17 00:00:00+00:00,-0.69,48933.89,2022-06,savings
2022-06-17 00:00:00+00:00,-9.73,48943.62,2022-06,groceries / food spend
2022-06-15 00:00:00+00:00,-28.52,48972.14,2022-06,groceries / food spend
2022-06-15 00:00:00+00:00,-0.55,48972.69,2022-06,savings
2022-06-15 00:00:00+00:00,-15.45,48988.14,2022-06,shopping
2022-06-15 00:00:00+00:00,-0.53,48988.67,2022-06,savings
2022-06-15 00:00:00+00:00,-3.59,48992.26,2022-06,shopping
2022-06-15 00:00:00+00:00,-24.49,49016.75,2022-06,shopping
2022-06-14 00:00:00+00:00,-1.13,49017.88,2022-06,entertainment
2022-06-14 00:00:00+00:00,-31.41,49049.29,2022-06,entertainment
2022-06-14 00:00:00+00:00,86.22,48963.07,2022-06,entertainment
2022-06-12 00:00:00+00:00,-0.47,48963.54,2022-06,savings
2022-06-12 00:00:00+00:00,-23.11,48986.65,2022-06,transport
2022-06-11 00:00:00+00:00,50.0,48936.65,2022-06,finances
2022-06-11 00:00:00+00:00,82.52,48854.13,2022-06,transfer
2022-06-11 00:00:00+00:00,22.42,48831.71,2022-06,taxes
2022-06-11 00:00:00+00:00,-17.16,48848.87,2022-06,holidays
2022-06-10 00:00:00+00:00,-40.0,48888.87,2022-06,finances
2022-06-10 00:00:00+00:00,-7.93,48896.8,2022-06,groceries / food spend
2022-06-10 00:00:00+00:00,40.0,48856.8,2022-06,transfer
2022-06-10 00:00:00+00:00,43.27,48813.53,2022-06,finances
2022-06-10 00:00:00+00:00,-30.0,48843.53,2022-06,transfer
2022-06-10 00:00:00+00:00,-24.49,48868.02,2022-06,bills and utilities
2022-06-09 00:00:00+00:00,-27.81,48895.83,2022-06,transport
2022-06-09 00:00:00+00:00,-20.56,48916.39,2022-06,taxes
2022-06-09 00:00:00+00:00,-0.41,48916.8,2022-06,savings
2022-06-09 00:00:00+00:00,-5.25,48922.05,2022-06,transfer
2022-06-08 00:00:00+00:00,-0.01,48922.06,2022-06,savings
2022-06-08 00:00:00+00:00,22.42,48899.64,2022-06,taxes
2022-06-08 00:00:00+00:00,-3.86,48903.5,2022-06,fees and charges
2022-06-08 00:00:00+00:00,-100.0,49003.5,2022-06,rent
2022-06-08 00:00:00+00:00,-0.08,49003.58,2022-06,entertainment
2022-06-08 00:00:00+00:00,-0.69,49004.27,2022-06,savings
2022-06-08 00:00:00+00:00,-1.04,49005.31,2022-06,savings
2022-06-08 00:00:00+00:00,-24.31,49029.62,2022-06,groceries / food spend
2022-06-07 00:00:00+00:00,-82.37,49111.99,2022-06,bills and utilities
2022-06-07 00:00:00+00:00,-1.15,49113.14,2022-06,savings
2022-06-07 00:00:00+00:00,-70.0,49183.14,2022-06,transfer
2022-06-06 00:00:00+00:00,-28.25,49211.39,2022-06,bills and utilities
2022-06-06 00:00:00+00:00,22.4,49188.99,2022-06,taxes
2022-06-06 00:00:00+00:00,-3.99,49192.98,2022-06,groceries / food spend
2022-06-06 00:00:00+00:00,-50.0,49242.98,2022-06,bills and utilities
2022-06-06 00:00:00+00:00,-9.75,49252.73,2022-06,home and garden
2022-06-06 00:00:00+00:00,326.34,48926.39,2022-06,taxes
2022-06-06 00:00:00+00:00,137.6,48788.79,2022-06,transfer
2022-06-06 00:00:00+00:00,61.89,48726.9,2022-06,transfer
2022-06-06 00:00:00+00:00,-0.01,48726.91,2022-06,savings
2022-06-06 00:00:00+00:00,-3.73,48730.64,2022-06,shopping
2022-06-05 00:00:00+00:00,-60.0,48790.64,2022-06,transfer
2022-06-05 00:00:00+00:00,-1.73,48792.37,2022-06,savings
2022-06-05 00:00:00+00:00,-6.16,48798.53,2022-06,finances
2022-06-05 00:00:00+00:00,-2.48,48801.01,2022-06,shopping
2022-06-05 00:00:00+00:00,-23.15,48824.16,2022-06,transfer
2022-06-05 00:00:00+00:00,-13.79,48837.95,2022-06,finances
2022-06-05 00:00:00+00:00,-1.4,48839.35,2022-06,groceries / food spend
2022-06-05 00:00:00+00:00,-20.0,48859.35,2022-06,shopping
2022-06-04 00:00:00+00:00,18.42,48840.93,2022-06,transfer
2022-06-04 00:00:00+00:00,23.7,48817.23,2022-06,transfer
2022-06-04 00:00:00+00:00,119.49,48697.74,2022-06,transfer
2022-06-04 00:00:00+00:00,-1.9,48699.64,2022-06,transfer
2022-06-04 00:00:00+00:00,-0.2,48699.84,2022-06,shopping
2022-06-04 00:00:00+00:00,-2.91,48702.75,2022-06,finances
2022-06-04 00:00:00+00:00,-100.0,48802.75,2022-06,transfer
2022-06-04 00:00:00+00:00,153.49,48649.26,2022-06,transfer
2022-06-04 00:00:00+00:00,-7.51,48656.77,2022-06,business services
2022-06-04 00:00:00+00:00,1.13,48655.64,2022-06,transfer
2022-06-04 00:00:00+00:00,-130.0,48785.64,2022-06,rent
2022-06-03 00:00:00+00:00,1.29,48784.35,2022-06,transfer
2022-06-03 00:00:00+00:00,-0.44,48784.79,2022-06,savings
2022-06-03 00:00:00+00:00,130.0,48654.79,2022-06,transfer
2022-06-03 00:00:00+00:00,3.93,48650.86,2022-06,transfer
2022-06-03 00:00:00+00:00,-23.11,48673.97,2022-06,transport
2022-06-03 00:00:00+00:00,32.21,48641.76,2022-06,entertainment
2022-06-03 00:00:00+00:00,-0.01,48641.77,2022-06,savings
2022-06-03 00:00:00+00:00,-2.99,48644.76,2022-06,entertainment
2022-06-03 00:00:00+00:00,-30.0,48674.76,2022-06,shopping
2022-06-03 00:00:00+00:00,64.09,48610.67,2022-06,transfer
2022-06-03 00:00:00+00:00,-30.54,48641.21,2022-06,transfer
2022-06-03 00:00:00+00:00,-5.0,48646.21,2022-06,groceries / food spend
2022-06-02 00:00:00+00:00,42.05,48604.16,2022-06,transfer
2022-06-02 00:00:00+00:00,-48.66,48652.82,2022-06,transfer
2022-06-02 00:00:00+00:00,10.0,48642.82,2022-06,transfer
2022-06-02 00:00:00+00:00,-0.6,48643.42,2022-06,savings
2022-06-01 00:00:00+00:00,-53.42,48696.84,2022-06,bills and utilities
2022-06-01 00:00:00+00:00,-0.01,48696.85,2022-06,fees and charges
2022-06-01 00:00:00+00:00,-227.0,48923.85,2022-06,transfer
2022-06-01 00:00:00+00:00,-51.27,48975.12,2022-06,groceries / food spend
2022-06-01 00:00:00+00:00,-0.01,48975.13,2022-06,finances
2022-06-01 00:00:00+00:00,-0.01,48975.14,2022-06,shopping
2022-06-01 00:00:00+00:00,-0.01,48975.15,2022-06,shopping
2022-06-01 00:00:00+00:00,-0.01,48975.16,2022-06,groceries / food spend
2022-06-01 00:00:00+00:00,-0.01,48975.17,2022-06,groceries / food spend
2022-06-01 00:00:00+00:00,-0.01,48975.18,2022-06,groceries / food spend
2022-06-01 00:00:00+00:00,-0.01,48975.19,2022-06,groceries / food spend
2022-06-01 00:00:00+00:00,-0.01,48975.2,2022-06,transport
2022-06-01 00:00:00+00:00,-362.2,49337.4,2022-06,restaurants / eating out / delivery
2022-06-01 00:00:00+00:00,-0.0,49337.4,2022-06,home and garden
2022-06-01 00:00:00+00:00,-0.02,49337.42,2022-06,fees and charges
2022-06-01 00:00:00+00:00,-0.01,49337.43,2022-06,transport
2022-06-01 00:00:00+00:00,-0.01,49337.44,2022-06,entertainment
2022-06-01 00:00:00+00:00,-0.01,49337.45,2022-06,fees and charges
2022-06-01 00:00:00+00:00,-22.14,49359.59,2022-06,groceries / food spend
2022-06-01 00:00:00+00:00,-8.79,49368.38,2022-06,transfer
2022-06-01 00:00:00+00:00,-13.17,49381.55,2022-06,business services
2022-06-01 00:00:00+00:00,-10.0,49391.55,2022-06,bills and utilities
2022-06-01 00:00:00+00:00,-10.1,49401.65,2022-06,finances
2022-06-01 00:00:00+00:00,-13.36,49415.01,2022-06,finances
2022-06-01 00:00:00+00:00,-9.09,49424.1,2022-06,bills and utilities
2022-05-28 00:00:00+00:00,313.0,49111.1,2022-05,transfer
2022-05-28 00:00:00+00:00,-36.59,49147.69,2022-05,shopping
2022-05-28 00:00:00+00:00,40.0,49107.69,2022-05,transfer
2022-05-28 00:00:00+00:00,-32.72,49140.41,2022-05,transfer
2022-05-28 00:00:00+00:00,22.42,49117.99,2022-05,taxes
2022-05-27 00:00:00+00:00,-7.93,49125.92,2022-05,transfer
2022-05-27 00:00:00+00:00,71.87,49054.05,2022-05,transfer
2022-05-27 00:00:00+00:00,19.82,49034.23,2022-05,transfer
2022-05-27 00:00:00+00:00,-11.27,49045.5,2022-05,transport
2022-05-27 00:00:00+00:00,-3.25,49048.75,2022-05,finances
2022-05-27 00:00:00+00:00,-15.86,49064.61,2022-05,groceries / food spend
2022-05-27 00:00:00+00:00,-7.56,49072.17,2022-05,shopping
2022-05-25 00:00:00+00:00,70.0,49002.17,2022-05,transfer
2022-05-25 00:00:00+00:00,-54.07,49056.24,2022-05,entertainment
2022-05-25 00:00:00+00:00,-10.0,49066.24,2022-05,transfer
2022-05-25 00:00:00+00:00,-0.41,49066.65,2022-05,savings
2022-05-25 00:00:00+00:00,-36.59,49103.24,2022-05,shopping
2022-05-25 00:00:00+00:00,-0.41,49103.65,2022-05,savings
2022-05-25 00:00:00+00:00,-10.5,49114.15,2022-05,entertainment
2022-05-23 00:00:00+00:00,-30.0,49144.15,2022-05,finances
2022-05-23 00:00:00+00:00,30.63,49113.52,2022-05,transfer
2022-05-23 00:00:00+00:00,-52.39,49165.91,2022-05,transfer
2022-05-23 00:00:00+00:00,-1.45,49167.36,2022-05,savings
2022-05-23 00:00:00+00:00,-20.0,49187.36,2022-05,transfer
2022-05-22 00:00:00+00:00,-4.66,49192.02,2022-05,shopping
2022-05-22 00:00:00+00:00,-0.01,49192.03,2022-05,savings
2022-05-22 00:00:00+00:00,-39.25,49231.28,2022-05,bills and utilities
2022-05-22 00:00:00+00:00,-36.59,49267.87,2022-05,shopping
2022-05-22 00:00:00+00:00,-36.73,49304.6,2022-05,finances
2022-05-20 00:00:00+00:00,-150.0,49454.6,2022-05,rent
2022-05-20 00:00:00+00:00,22.99,49431.61,2022-05,taxes
2022-05-20 00:00:00+00:00,-550.0,49981.61,2022-05,business services
2022-05-20 00:00:00+00:00,345.13,49636.48,2022-05,taxes
2022-05-19 00:00:00+00:00,-7.99,49644.47,2022-05,shopping
2022-05-19 00:00:00+00:00,1450.42,48194.05,2022-05,salary
2022-05-18 00:00:00+00:00,82.21,48111.84,2022-05,finances
2022-05-17 00:00:00+00:00,137.6,47974.24,2022-05,transfer
2022-05-17 00:00:00+00:00,-12.73,47986.97,2022-05,finances
2022-05-17 00:00:00+00:00,-43.14,48030.11,2022-05,finances
2022-05-17 00:00:00+00:00,-20.0,48050.11,2022-05,transport
2022-05-17 00:00:00+00:00,-0.59,48050.7,2022-05,savings
2022-05-17 00:00:00+00:00,-6.37,48057.07,2022-05,groceries / food spend
2022-05-15 00:00:00+00:00,-62.71,48119.78,2022-05,groceries / food spend
2022-05-15 00:00:00+00:00,-0.55,48120.33,2022-05,savings
2022-05-15 00:00:00+00:00,-33.49,48153.82,2022-05,shopping
2022-05-15 00:00:00+00:00,-0.5,48154.32,2022-05,savings
2022-05-15 00:00:00+00:00,-3.59,48157.91,2022-05,shopping
2022-05-15 00:00:00+00:00,-10.0,48167.91,2022-05,shopping
2022-05-14 00:00:00+00:00,-2.0,48169.91,2022-05,entertainment
2022-05-14 00:00:00+00:00,-20.5,48190.41,2022-05,entertainment
2022-05-14 00:00:00+00:00,43.5,48146.91,2022-05,entertainment
2022-05-12 00:00:00+00:00,-0.42,48147.33,2022-05,savings
2022-05-12 00:00:00+00:00,-23.11,48170.44,2022-05,transport
2022-05-11 00:00:00+00:00,50.0,48120.44,2022-05,finances
2022-05-11 00:00:00+00:00,50.0,48070.44,2022-05,transfer
2022-05-11 00:00:00+00:00,22.42,48048.02,2022-05,taxes
2022-05-11 00:00:00+00:00,-16.77,48064.79,2022-05,holidays
2022-05-10 00:00:00+00:00,-40.0,48104.79,2022-05,finances
2022-05-10 00:00:00+00:00,-5.31,48110.1,2022-05,groceries / food spend
2022-05-10 00:00:00+00:00,32.34,48077.76,2022-05,transfer
2022-05-10 00:00:00+00:00,57.96,48019.8,2022-05,finances
2022-05-10 00:00:00+00:00,-30.0,48049.8,2022-05,transfer
2022-05-10 00:00:00+00:00,-24.5,48074.3,2022-05,bills and utilities
2022-05-09 00:00:00+00:00,-27.41,48101.71,2022-05,transport
2022-05-09 00:00:00+00:00,-20.56,48122.27,2022-05,taxes
2022-05-09 00:00:00+00:00,-0.42,48122.69,2022-05,savings
2022-05-09 00:00:00+00:00,70.0,48052.69,2022-05,transfer
2022-05-08 00:00:00+00:00,-0.01,48052.7,2022-05,savings
2022-05-08 00:00:00+00:00,22.42,48030.28,2022-05,taxes
2022-05-08 00:00:00+00:00,-14.99,48045.27,2022-05,fees and charges
2022-05-08 00:00:00+00:00,-100.0,48145.27,2022-05,rent
2022-05-08 00:00:00+00:00,-10.0,48155.27,2022-05,entertainment
2022-05-08 00:00:00+00:00,-0.86,48156.13,2022-05,savings
2022-05-08 00:00:00+00:00,-0.81,48156.94,2022-05,savings
2022-05-08 00:00:00+00:00,-10.16,48167.1,2022-05,groceries / food spend
2022-05-07 00:00:00+00:00,-82.37,48249.47,2022-05,bills and utilities
2022-05-07 00:00:00+00:00,-1.15,48250.62,2022-05,savings
2022-05-07 00:00:00+00:00,-9.82,48260.44,2022-05,transfer
2022-05-06 00:00:00+00:00,-28.25,48288.69,2022-05,bills and utilities
2022-05-06 00:00:00+00:00,22.42,48266.27,2022-05,taxes
2022-05-06 00:00:00+00:00,2.12,48264.15,2022-05,groceries / food spend
2022-05-06 00:00:00+00:00,-50.0,48314.15,2022-05,bills and utilities
2022-05-06 00:00:00+00:00,-11.45,48325.6,2022-05,home and garden
2022-05-06 00:00:00+00:00,346.35,47979.25,2022-05,taxes
2022-05-06 00:00:00+00:00,137.6,47841.65,2022-05,transfer
2022-05-06 00:00:00+00:00,61.89,47779.76,2022-05,transfer
2022-05-06 00:00:00+00:00,-0.01,47779.77,2022-05,savings
2022-05-06 00:00:00+00:00,-4.88,47784.65,2022-05,shopping
2022-05-05 00:00:00+00:00,-60.0,47844.65,2022-05,transfer
2022-05-05 00:00:00+00:00,-1.89,47846.54,2022-05,savings
2022-05-05 00:00:00+00:00,-5.79,47852.33,2022-05,finances
2022-05-05 00:00:00+00:00,-7.67,47860.0,2022-05,shopping
2022-05-05 00:00:00+00:00,-23.15,47883.15,2022-05,transfer
2022-05-05 00:00:00+00:00,-15.25,47898.4,2022-05,finances
2022-05-05 00:00:00+00:00,-8.32,47906.72,2022-05,groceries / food spend
2022-05-05 00:00:00+00:00,-29.42,47936.14,2022-05,shopping
2022-05-04 00:00:00+00:00,11.42,47924.72,2022-05,transfer
2022-05-04 00:00:00+00:00,70.0,47854.72,2022-05,transfer
2022-05-04 00:00:00+00:00,59.17,47795.55,2022-05,transfer
2022-05-04 00:00:00+00:00,-22.56,47818.11,2022-05,transfer
2022-05-04 00:00:00+00:00,-5.0,47823.11,2022-05,shopping
2022-05-04 00:00:00+00:00,-3.21,47826.32,2022-05,finances
2022-05-04 00:00:00+00:00,-108.82,47935.14,2022-05,transfer
2022-05-04 00:00:00+00:00,145.01,47790.13,2022-05,transfer
2022-05-04 00:00:00+00:00,-3.59,47793.72,2022-05,business services
2022-05-04 00:00:00+00:00,25.0,47768.72,2022-05,transfer
2022-05-04 00:00:00+00:00,-130.0,47898.72,2022-05,rent
2022-05-03 00:00:00+00:00,0.89,47897.83,2022-05,transfer
2022-05-03 00:00:00+00:00,-0.43,47898.26,2022-05,savings
2022-05-03 00:00:00+00:00,84.89,47813.37,2022-05,transfer
2022-05-03 00:00:00+00:00,7.0,47806.37,2022-05,transfer
2022-05-03 00:00:00+00:00,-23.11,47829.48,2022-05,transport
2022-05-03 00:00:00+00:00,35.49,47793.99,2022-05,entertainment
2022-05-03 00:00:00+00:00,-0.01,47794.0,2022-05,savings
2022-05-03 00:00:00+00:00,-0.92,47794.92,2022-05,entertainment
2022-05-03 00:00:00+00:00,-30.0,47824.92,2022-05,shopping
2022-05-03 00:00:00+00:00,62.87,47762.05,2022-05,transfer
2022-05-03 00:00:00+00:00,-40.0,47802.05,2022-05,transfer
2022-05-03 00:00:00+00:00,-5.0,47807.05,2022-05,groceries / food spend
2022-05-02 00:00:00+00:00,30.0,47777.05,2022-05,transfer
2022-05-02 00:00:00+00:00,-23.65,47800.7,2022-05,transfer
2022-05-02 00:00:00+00:00,10.0,47790.7,2022-05,transfer
2022-05-02 00:00:00+00:00,-0.59,47791.29,2022-05,savings
2022-05-01 00:00:00+00:00,-47.88,47839.17,2022-05,bills and utilities
2022-05-01 00:00:00+00:00,-0.01,47839.18,2022-05,fees and charges
2022-05-01 00:00:00+00:00,-227.0,48066.18,2022-05,transfer
2022-05-01 00:00:00+00:00,-51.56,48117.74,2022-05,groceries / food spend
2022-05-01 00:00:00+00:00,-0.01,48117.75,2022-05,finances
2022-05-01 00:00:00+00:00,-0.01,48117.76,2022-05,shopping
2022-05-01 00:00:00+00:00,-0.02,48117.78,2022-05,shopping
2022-05-01 00:00:00+00:00,-0.01,48117.79,2022-05,groceries / food spend
2022-05-01 00:00:00+00:00,-0.01,48117.8,2022-05,groceries / food spend
2022-05-01 00:00:00+00:00,-0.01,48117.81,2022-05,groceries / food spend
2022-05-01 00:00:00+00:00,-0.01,48117.82,2022-05,groceries / food spend
2022-05-01 00:00:00+00:00,-0.01,48117.83,2022-05,transport
2022-05-01 00:00:00+00:00,-173.3,48291.13,2022-05,restaurants / eating out / delivery
2022-05-01 00:00:00+00:00,-0.01,48291.14,2022-05,home and garden
2022-05-01 00:00:00+00:00,-0.02,48291.16,2022-05,fees and charges
2022-05-01 00:00:00+00:00,-0.01,48291.17,2022-05,transport
2022-05-01 00:00:00+00:00,-0.01,48291.18,2022-05,entertainment
2022-05-01 00:00:00+00:00,-0.02,48291.2,2022-05,fees and charges
2022-05-01 00:00:00+00:00,-23.99,48315.19,2022-05,groceries / food spend
2022-05-01 00:00:00+00:00,-20.91,48336.1,2022-05,transfer
2022-05-01 00:00:00+00:00,-10.0,48346.1,2022-05,business services
2022-05-01 00:00:00+00:00,-10.94,48357.04,2022-05,bills and utilities
2022-05-01 00:00:00+00:00,-10.0,48367.04,2022-05,finances
2022-05-01 00:00:00+00:00,-8.22,48375.26,2022-05,finances
2022-05-01 00:00:00+00:00,-10.0,48385.26,2022-05,bills and utilities
2022-04-28 00:00:00+00:00,420.0,47965.26,2022-04,transfer
2022-04-28 00:00:00+00:00,-36.59,48001.85,2022-04,shopping
2022-04-28 00:00:00+00:00,23.47,47978.38,2022-04,transfer
2022-04-28 00:00:00+00:00,-32.72,48011.1,2022-04,transfer
2022-04-28 00:00:00+00:00,22.45,47988.65,2022-04,taxes
2022-04-27 00:00:00+00:00,-7.93,47996.58,2022-04,transfer
2022-04-27 00:00:00+00:00,50.59,47945.99,2022-04,transfer
2022-04-27 00:00:00+00:00,15.86,47930.13,2022-04,transfer
2022-04-27 00:00:00+00:00,-15.65,47945.78,2022-04,transport
2022-04-27 00:00:00+00:00,-2.95,47948.73,2022-04,finances
2022-04-27 00:00:00+00:00,-54.67,48003.4,2022-04,groceries / food spend
2022-04-27 00:00:00+00:00,-13.16,48016.56,2022-04,shopping
2022-04-25 00:00:00+00:00,52.46,47964.1,2022-04,transfer
2022-04-25 00:00:00+00:00,-24.5,47988.6,2022-04,entertainment
2022-04-25 00:00:00+00:00,-1.9,47990.5,2022-04,transfer
2022-04-25 00:00:00+00:00,-0.41,47990.91,2022-04,savings
2022-04-25 00:00:00+00:00,-36.59,48027.5,2022-04,shopping
2022-04-25 00:00:00+00:00,-0.5,48028.0,2022-04,savings
2022-04-25 00:00:00+00:00,-10.5,48038.5,2022-04,entertainment
2022-04-23 00:00:00+00:00,-32.98,48071.48,2022-04,finances
2022-04-23 00:00:00+00:00,42.28,48029.2,2022-04,transfer
2022-04-23 00:00:00+00:00,-106.89,48136.09,2022-04,transfer
2022-04-23 00:00:00+00:00,-1.65,48137.74,2022-04,savings
2022-04-23 00:00:00+00:00,-20.0,48157.74,2022-04,transfer
2022-04-22 00:00:00+00:00,-8.22,48165.96,2022-04,shopping
2022-04-22 00:00:00+00:00,-0.01,48165.97,2022-04,savings
2022-04-22 00:00:00+00:00,-36.54,48202.51,2022-04,bills and utilities
2022-04-22 00:00:00+00:00,-36.59,48239.1,2022-04,shopping
2022-04-22 00:00:00+00:00,-38.07,48277.17,2022-04,finances
2022-04-20 00:00:00+00:00,-150.0,48427.17,2022-04,rent
2022-04-20 00:00:00+00:00,22.42,48404.75,2022-04,taxes
2022-04-20 00:00:00+00:00,-859.22,49263.97,2022-04,business services
2022-04-20 00:00:00+00:00,345.13,48918.84,2022-04,taxes
2022-04-19 00:00:00+00:00,-12.59,48931.43,2022-04,shopping
2022-04-19 00:00:00+00:00,1450.42,47481.01,2022-04,salary
2022-04-18 00:00:00+00:00,67.98,47413.03,2022-04,finances
2022-04-17 00:00:00+00:00,163.15,47249.88,2022-04,transfer
2022-04-17 00:00:00+00:00,-12.73,47262.61,2022-04,finances
2022-04-17 00:00:00+00:00,-40.0,47302.61,2022-04,finances
2022-04-17 00:00:00+00:00,-17.58,47320.19,2022-04,transport
2022-04-17 00:00:00+00:00,-0.64,47320.83,2022-04,savings
2022-04-17 00:00:00+00:00,-6.37,47327.2,2022-04,groceries / food spend
2022-04-15 00:00:00+00:00,-16.52,47343.72,2022-04,groceries / food spend
2022-04-15 00:00:00+00:00,-0.49,47344.21,2022-04,savings
2022-04-15 00:00:00+00:00,-4.69,47348.9,2022-04,shopping
2022-04-15 00:00:00+00:00,-0.51,47349.41,2022-04,savings
2022-04-15 00:00:00+00:00,-3.59,47353.0,2022-04,shopping
2022-04-15 00:00:00+00:00,-16.41,47369.41,2022-04,shopping
2022-04-14 00:00:00+00:00,-2.0,47371.41,2022-04,entertainment
2022-04-14 00:00:00+00:00,-61.69,47433.1,2022-04,entertainment
2022-04-14 00:00:00+00:00,43.5,47389.6,2022-04,entertainment
2022-04-12 00:00:00+00:00,-0.41,47390.01,2022-04,savings
2022-04-12 00:00:00+00:00,-22.24,47412.25,2022-04,transport
2022-04-11 00:00:00+00:00,46.08,47366.17,2022-04,finances
2022-04-11 00:00:00+00:00,17.4,47348.77,2022-04,transfer
2022-04-11 00:00:00+00:00,22.42,47326.35,2022-04,taxes
2022-04-11 00:00:00+00:00,-46.4,47372.75,2022-04,holidays
2022-04-10 00:00:00+00:00,-48.32,47421.07,2022-04,finances
2022-04-10 00:00:00+00:00,-4.4,47425.47,2022-04,groceries / food spend
2022-04-10 00:00:00+00:00,40.0,47385.47,2022-04,transfer
2022-04-10 00:00:00+00:00,50.36,47335.11,2022-04,finances
2022-04-10 00:00:00+00:00,-30.0,47365.11,2022-04,transfer
2022-04-10 00:00:00+00:00,-24.5,47389.61,2022-04,bills and utilities
2022-04-09 00:00:00+00:00,-30.6,47420.21,2022-04,transport
2022-04-09 00:00:00+00:00,-21.17,47441.38,2022-04,taxes
2022-04-09 00:00:00+00:00,-0.4,47441.78,2022-04,savings
2022-04-09 00:00:00+00:00,70.0,47371.78,2022-04,transfer
2022-04-08 00:00:00+00:00,-0.01,47371.79,2022-04,savings
2022-04-08 00:00:00+00:00,25.22,47346.57,2022-04,taxes
2022-04-08 00:00:00+00:00,-14.76,47361.33,2022-04,fees and charges
2022-04-08 00:00:00+00:00,-100.0,47461.33,2022-04,rent
2022-04-08 00:00:00+00:00,-10.0,47471.33,2022-04,entertainment
2022-04-08 00:00:00+00:00,-0.69,47472.02,2022-04,savings
2022-04-08 00:00:00+00:00,-1.04,47473.06,2022-04,savings
2022-04-08 00:00:00+00:00,-34.28,47507.34,2022-04,groceries / food spend
2022-04-07 00:00:00+00:00,-82.37,47589.71,2022-04,bills and utilities
2022-04-07 00:00:00+00:00,-1.15,47590.86,2022-04,savings
2022-04-07 00:00:00+00:00,-62.13,47652.99,2022-04,transfer
2022-04-06 00:00:00+00:00,-26.49,47679.48,2022-04,bills and utilities
2022-04-06 00:00:00+00:00,21.92,47657.56,2022-04,taxes
2022-04-06 00:00:00+00:00,-5.05,47662.61,2022-04,groceries / food spend
2022-04-06 00:00:00+00:00,-43.96,47706.57,2022-04,bills and utilities
2022-04-06 00:00:00+00:00,-11.66,47718.23,2022-04,home and garden
2022-04-06 00:00:00+00:00,346.35,47371.88,2022-04,taxes
2022-04-06 00:00:00+00:00,137.6,47234.28,2022-04,transfer
2022-04-06 00:00:00+00:00,61.89,47172.39,2022-04,transfer
2022-04-06 00:00:00+00:00,-0.01,47172.4,2022-04,savings
2022-04-06 00:00:00+00:00,-3.49,47175.89,2022-04,shopping
2022-04-05 00:00:00+00:00,-60.0,47235.89,2022-04,transfer
2022-04-05 00:00:00+00:00,-1.89,47237.78,2022-04,savings
2022-04-05 00:00:00+00:00,-5.79,47243.57,2022-04,finances
2022-04-05 00:00:00+00:00,-7.99,47251.56,2022-04,shopping
2022-04-05 00:00:00+00:00,-23.15,47274.71,2022-04,transfer
2022-04-05 00:00:00+00:00,-12.73,47287.44,2022-04,finances
2022-04-05 00:00:00+00:00,-6.71,47294.15,2022-04,groceries / food spend
2022-04-05 00:00:00+00:00,-10.46,47304.61,2022-04,shopping
2022-04-04 00:00:00+00:00,10.0,47294.61,2022-04,transfer
2022-04-04 00:00:00+00:00,70.0,47224.61,2022-04,transfer
2022-04-04 00:00:00+00:00,43.88,47180.73,2022-04,transfer
2022-04-04 00:00:00+00:00,-31.26,47211.99,2022-04,transfer
2022-04-04 00:00:00+00:00,-9.65,47221.64,2022-04,shopping
2022-04-04 00:00:00+00:00,-2.96,47224.6,2022-04,finances
2022-04-04 00:00:00+00:00,-100.0,47324.6,2022-04,transfer
2022-04-04 00:00:00+00:00,100.0,47224.6,2022-04,transfer
2022-04-04 00:00:00+00:00,-2.15,47226.75,2022-04,business services
2022-04-04 00:00:00+00:00,25.0,47201.75,2022-04,transfer
2022-04-04 00:00:00+00:00,-130.0,47331.75,2022-04,rent
2022-04-03 00:00:00+00:00,1.48,47330.27,2022-04,transfer
2022-04-03 00:00:00+00:00,-0.41,47330.68,2022-04,savings
2022-04-03 00:00:00+00:00,130.0,47200.68,2022-04,transfer
2022-04-03 00:00:00+00:00,9.41,47191.27,2022-04,transfer
2022-04-03 00:00:00+00:00,-23.11,47214.38,2022-04,transport
2022-04-03 00:00:00+00:00,10.89,47203.49,2022-04,entertainment
2022-04-03 00:00:00+00:00,-0.01,47203.5,2022-04,savings
2022-04-03 00:00:00+00:00,-1.61,47205.11,2022-04,entertainment
2022-04-03 00:00:00+00:00,13.92,47191.19,2022-04,shopping
2022-04-03 00:00:00+00:00,56.61,47134.58,2022-04,transfer
2022-04-03 00:00:00+00:00,-15.21,47149.79,2022-04,transfer
2022-04-03 00:00:00+00:00,-2.92,47152.71,2022-04,groceries / food spend
2022-04-02 00:00:00+00:00,26.79,47125.92,2022-04,transfer
2022-04-02 00:00:00+00:00,-24.25,47150.17,2022-04,transfer
2022-04-02 00:00:00+00:00,4.85,47145.32,2022-04,transfer
2022-04-02 00:00:00+00:00,-0.67,47145.99,2022-04,savings
2022-04-01 00:00:00+00:00,-47.41,47193.4,2022-04,bills and utilities
2022-04-01 00:00:00+00:00,-0.01,47193.41,2022-04,fees and charges
2022-04-01 00:00:00+00:00,-227.0,47420.41,2022-04,transfer
2022-04-01 00:00:00+00:00,-39.99,47460.4,2022-04,groceries / food spend
2022-04-01 00:00:00+00:00,-0.01,47460.41,2022-04,finances
2022-04-01 00:00:00+00:00,-0.01,47460.42,2022-04,shopping
2022-04-01 00:00:00+00:00,-0.01,47460.43,2022-04,shopping
2022-04-01 00:00:00+00:00,-0.01,47460.44,2022-04,groceries / food spend
2022-04-01 00:00:00+00:00,-0.02,47460.46,2022-04,groceries / food spend
2022-04-01 00:00:00+00:00,-0.01,47460.47,2022-04,groceries / food spend
2022-04-01 00:00:00+00:00,-0.01,47460.48,2022-04,groceries / food spend
2022-04-01 00:00:00+00:00,-0.01,47460.49,2022-04,transport
2022-04-01 00:00:00+00:00,-226.46,47686.95,2022-04,restaurants / eating out / delivery
2022-04-01 00:00:00+00:00,-0.01,47686.96,2022-04,home and garden
2022-04-01 00:00:00+00:00,-0.0,47686.96,2022-04,fees and charges
2022-04-01 00:00:00+00:00,-0.01,47686.97,2022-04,transport
2022-04-01 00:00:00+00:00,-0.01,47686.98,2022-04,entertainment
2022-04-01 00:00:00+00:00,-0.01,47686.99,2022-04,fees and charges
2022-04-01 00:00:00+00:00,-25.52,47712.51,2022-04,groceries / food spend
2022-04-01 00:00:00+00:00,-20.91,47733.42,2022-04,transfer
2022-04-01 00:00:00+00:00,-10.0,47743.42,2022-04,business services
2022-04-01 00:00:00+00:00,-10.0,47753.42,2022-04,bills and utilities
2022-04-01 00:00:00+00:00,-9.83,47763.25,2022-04,finances
2022-04-01 00:00:00+00:00,-10.0,47773.25,2022-04,finances
2022-04-01 00:00:00+00:00,-9.71,47782.96,2022-04,bills and utilities
2022-03-28 00:00:00+00:00,326.86,47456.1,2022-03,transfer
2022-03-28 00:00:00+00:00,-44.61,47500.71,2022-03,shopping
2022-03-28 00:00:00+00:00,40.0,47460.71,2022-03,transfer
2022-03-28 00:00:00+00:00,-32.72,47493.43,2022-03,transfer
2022-03-28 00:00:00+00:00,21.47,47471.96,2022-03,taxes
2022-03-27 00:00:00+00:00,-6.06,47478.02,2022-03,transfer
2022-03-27 00:00:00+00:00,58.52,47419.5,2022-03,transfer
2022-03-27 00:00:00+00:00,15.86,47403.64,2022-03,transfer
2022-03-27 00:00:00+00:00,-17.53,47421.17,2022-03,transport
2022-03-27 00:00:00+00:00,-2.99,47424.16,2022-03,finances
2022-03-27 00:00:00+00:00,-2.76,47426.92,2022-03,groceries / food spend
2022-03-27 00:00:00+00:00,-4.12,47431.04,2022-03,shopping
2022-03-25 00:00:00+00:00,70.0,47361.04,2022-03,transfer
2022-03-25 00:00:00+00:00,16.51,47344.53,2022-03,entertainment
2022-03-25 00:00:00+00:00,-10.0,47354.53,2022-03,transfer
2022-03-25 00:00:00+00:00,-0.41,47354.94,2022-03,savings
2022-03-25 00:00:00+00:00,-47.55,47402.49,2022-03,shopping
2022-03-25 00:00:00+00:00,-0.47,47402.96,2022-03,savings
2022-03-25 00:00:00+00:00,-10.5,47413.46,2022-03,entertainment
2022-03-23 00:00:00+00:00,-30.0,47443.46,2022-03,finances
2022-03-23 00:00:00+00:00,32.5,47410.96,2022-03,transfer
2022-03-23 00:00:00+00:00,-55.73,47466.69,2022-03,transfer
2022-03-23 00:00:00+00:00,-1.57,47468.26,2022-03,savings
2022-03-23 00:00:00+00:00,-20.0,47488.26,2022-03,transfer
2022-03-22 00:00:00+00:00,-8.18,47496.44,2022-03,shopping
2022-03-22 00:00:00+00:00,-0.01,47496.45,2022-03,savings
2022-03-22 00:00:00+00:00,-39.25,47535.7,2022-03,bills and utilities
2022-03-22 00:00:00+00:00,-36.59,47572.29,2022-03,shopping
2022-03-22 00:00:00+00:00,-37.17,47609.46,2022-03,finances
2022-03-20 00:00:00+00:00,-150.0,47759.46,2022-03,rent
2022-03-20 00:00:00+00:00,24.71,47734.75,2022-03,taxes
2022-03-20 00:00:00+00:00,-550.0,48284.75,2022-03,business services
2022-03-20 00:00:00+00:00,345.13,47939.62,2022-03,taxes
2022-03-19 00:00:00+00:00,-13.04,47952.66,2022-03,shopping
2022-03-19 00:00:00+00:00,1450.42,46502.24,2022-03,salary
2022-03-18 00:00:00+00:00,82.21,46420.03,2022-03,finances
2022-03-17 00:00:00+00:00,137.6,46282.43,2022-03,transfer
2022-03-17 00:00:00+00:00,-12.73,46295.16,2022-03,finances
2022-03-17 00:00:00+00:00,-40.0,46335.16,2022-03,finances
2022-03-17 00:00:00+00:00,-20.0,46355.16,2022-03,transport
2022-03-17 00:00:00+00:00,-0.63,46355.79,2022-03,savings
2022-03-17 00:00:00+00:00,1.16,46354.63,2022-03,groceries / food spend
2022-03-15 00:00:00+00:00,-32.0,46386.63,2022-03,groceries / food spend
2022-03-15 00:00:00+00:00,-0.55,46387.18,2022-03,savings
2022-03-15 00:00:00+00:00,-15.45,46402.63,2022-03,shopping
2022-03-15 00:00:00+00:00,-0.5,46403.13,2022-03,savings
2022-03-15 00:00:00+00:00,-3.59,46406.72,2022-03,shopping
2022-03-15 00:00:00+00:00,-19.59,46426.31,2022-03,shopping
2022-03-14 00:00:00+00:00,-3.1,46429.41,2022-03,entertainment
2022-03-14 00:00:00+00:00,-20.5,46449.91,2022-03,entertainment
2022-03-14 00:00:00+00:00,43.5,46406.41,2022-03,entertainment
2022-03-12 00:00:00+00:00,-0.41,46406.82,2022-03,savings
2022-03-12 00:00:00+00:00,-15.32,46422.14,2022-03,transport
2022-03-11 00:00:00+00:00,44.95,46377.19,2022-03,finances
2022-03-11 00:00:00+00:00,31.7,46345.49,2022-03,transfer
2022-03-11 00:00:00+00:00,22.42,46323.07,2022-03,taxes
2022-03-11 00:00:00+00:00,-17.0,46340.07,2022-03,holidays
2022-03-10 00:00:00+00:00,-31.15,46371.22,2022-03,finances
2022-03-10 00:00:00+00:00,-1.65,46372.87,2022-03,groceries / food spend
2022-03-10 00:00:00+00:00,40.0,46332.87,2022-03,transfer
2022-03-10 00:00:00+00:00,40.12,46292.75,2022-03,finances
2022-03-10 00:00:00+00:00,-30.0,46322.75,2022-03,transfer
2022-03-10 00:00:00+00:00,-22.5,46345.25,2022-03,bills and utilities
2022-03-09 00:00:00+00:00,-23.62,46368.87,2022-03,transport
2022-03-09 00:00:00+00:00,-20.7,46389.57,2022-03,taxes
2022-03-09 00:00:00+00:00,-0.42,46389.99,2022-03,savings
2022-03-09 00:00:00+00:00,70.0,46319.99,2022-03,transfer
2022-03-08 00:00:00+00:00,-0.01,46320.0,2022-03,savings
2022-03-08 00:00:00+00:00,22.42,46297.58,2022-03,taxes
2022-03-08 00:00:00+00:00,-14.99,46312.57,2022-03,fees and charges
2022-03-08 00:00:00+00:00,-100.0,46412.57,2022-03,rent
2022-03-08 00:00:00+00:00,-4.94,46417.51,2022-03,entertainment
2022-03-08 00:00:00+00:00,-0.69,46418.2,2022-03,savings
2022-03-08 00:00:00+00:00,-1.09,46419.29,2022-03,savings
2022-03-08 00:00:00+00:00,-26.08,46445.37,2022-03,groceries / food spend
2022-03-07 00:00:00+00:00,-82.37,46527.74,2022-03,bills and utilities
2022-03-07 00:00:00+00:00,-1.3,46529.04,2022-03,savings
2022-03-07 00:00:00+00:00,-105.74,46634.78,2022-03,transfer
2022-03-06 00:00:00+00:00,-24.67,46659.45,2022-03,bills and utilities
2022-03-06 00:00:00+00:00,22.29,46637.16,2022-03,taxes
2022-03-06 00:00:00+00:00,-3.75,46640.91,2022-03,groceries / food spend
2022-03-06 00:00:00+00:00,-55.03,46695.94,2022-03,bills and utilities
2022-03-06 00:00:00+00:00,-23.59,46719.53,2022-03,home and garden
2022-03-06 00:00:00+00:00,346.35,46373.18,2022-03,taxes
2022-03-06 00:00:00+00:00,214.29,46158.89,2022-03,transfer
2022-03-06 00:00:00+00:00,92.14,46066.75,2022-03,transfer
2022-03-06 00:00:00+00:00,-0.01,46066.76,2022-03,savings
2022-03-06 00:00:00+00:00,-5.0,46071.76,2022-03,shopping
2022-03-05 00:00:00+00:00,-60.0,46131.76,2022-03,transfer
2022-03-05 00:00:00+00:00,-1.92,46133.68,2022-03,savings
2022-03-05 00:00:00+00:00,-5.67,46139.35,2022-03,finances
2022-03-05 00:00:00+00:00,-7.99,46147.34,2022-03,shopping
2022-03-05 00:00:00+00:00,-23.15,46170.49,2022-03,transfer
2022-03-05 00:00:00+00:00,-13.06,46183.55,2022-03,finances
2022-03-05 00:00:00+00:00,-5.52,46189.07,2022-03,groceries / food spend
2022-03-05 00:00:00+00:00,-43.06,46232.13,2022-03,shopping
2022-03-04 00:00:00+00:00,10.0,46222.13,2022-03,transfer
2022-03-04 00:00:00+00:00,70.0,46152.13,2022-03,transfer
2022-03-04 00:00:00+00:00,35.81,46116.32,2022-03,transfer
2022-03-04 00:00:00+00:00,-17.91,46134.23,2022-03,transfer
2022-03-04 00:00:00+00:00,-5.22,46139.45,2022-03,shopping
2022-03-04 00:00:00+00:00,-3.07,46142.52,2022-03,finances
2022-03-04 00:00:00+00:00,-100.0,46242.52,2022-03,transfer
2022-03-04 00:00:00+00:00,165.73,46076.79,2022-03,transfer
2022-03-04 00:00:00+00:00,-3.64,46080.43,2022-03,business services
2022-03-04 00:00:00+00:00,25.77,46054.66,2022-03,transfer
2022-03-04 00:00:00+00:00,-130.0,46184.66,2022-03,rent
2022-03-03 00:00:00+00:00,0.49,46184.17,2022-03,transfer
2022-03-03 00:00:00+00:00,-0.41,46184.58,2022-03,savings
2022-03-03 00:00:00+00:00,130.0,46054.58,2022-03,transfer
2022-03-03 00:00:00+00:00,8.22,46046.36,2022-03,transfer
2022-03-03 00:00:00+00:00,-23.11,46069.47,2022-03,transport
2022-03-03 00:00:00+00:00,35.49,46033.98,2022-03,entertainment
2022-03-03 00:00:00+00:00,-0.01,46033.99,2022-03,savings
2022-03-03 00:00:00+00:00,-1.77,46035.76,2022-03,entertainment
2022-03-03 00:00:00+00:00,-30.0,46065.76,2022-03,shopping
2022-03-03 00:00:00+00:00,29.92,46035.84,2022-03,transfer
2022-03-03 00:00:00+00:00,-40.0,46075.84,2022-03,transfer
2022-03-03 00:00:00+00:00,-5.0,46080.84,2022-03,groceries / food spend
2022-03-02 00:00:00+00:00,30.0,46050.84,2022-03,transfer
2022-03-02 00:00:00+00:00,-46.82,46097.66,2022-03,transfer
2022-03-02 00:00:00+00:00,2.98,46094.68,2022-03,transfer
2022-03-02 00:00:00+00:00,-0.55,46095.23,2022-03,savings
2022-03-01 00:00:00+00:00,-46.42,46141.65,2022-03,bills and utilities
2022-03-01 00:00:00+00:00,-0.01,46141.66,2022-03,fees and charges
2022-03-01 00:00:00+00:00,-244.29,46385.95,2022-03,transfer
2022-03-01 00:00:00+00:00,-6.26,46392.21,2022-03,groceries / food spend
2022-03-01 00:00:00+00:00,-0.01,46392.22,2022-03,finances
2022-03-01 00:00:00+00:00,-0.01,46392.23,2022-03,shopping
2022-03-01 00:00:00+00:00,-0.01,46392.24,2022-03,shopping
2022-03-01 00:00:00+00:00,-0.01,46392.25,2022-03,groceries / food spend
2022-03-01 00:00:00+00:00,-0.01,46392.26,2022-03,groceries / food spend
2022-03-01 00:00:00+00:00,-0.01,46392.27,2022-03,groceries / food spend
2022-03-01 00:00:00+00:00,-0.02,46392.29,2022-03,groceries / food spend
2022-03-01 00:00:00+00:00,-0.01,46392.3,2022-03,transport
2022-03-01 00:00:00+00:00,-200.0,46592.3,2022-03,restaurants / eating out / delivery
2022-03-01 00:00:00+00:00,-0.01,46592.31,2022-03,home and garden
2022-03-01 00:00:00+00:00,-0.01,46592.32,2022-03,fees and charges
2022-03-01 00:00:00+00:00,-0.01,46592.33,2022-03,transport
2022-03-01 00:00:00+00:00,-0.01,46592.34,2022-03,entertainment
2022-03-01 00:00:00+00:00,-0.01,46592.35,2022-03,fees and charges
2022-03-01 00:00:00+00:00,-23.99,46616.34,2022-03,groceries / food spend
2022-03-01 00:00:00+00:00,-6.53,46622.87,2022-03,transfer
2022-03-01 00:00:00+00:00,-13.05,46635.92,2022-03,business services
2022-03-01 00:00:00+00:00,-8.45,46644.37,2022-03,bills and utilities
2022-03-01 00:00:00+00:00,-11.72,46656.09,2022-03,finances
2022-03-01 00:00:00+00:00,-10.0,46666.09,2022-03,finances
2022-03-01 00:00:00+00:00,-10.0,46676.09,2022-03,bills and utilities
2022-02-28 00:00:00+00:00,420.0,46256.09,2022-02,transfer
2022-02-28 00:00:00+00:00,-92.84,46348.93,2022-02,shopping
2022-02-28 00:00:00+00:00,40.0,46308.93,2022-02,transfer
2022-02-28 00:00:00+00:00,8.49,46300.44,2022-02,transfer
2022-02-28 00:00:00+00:00,22.02,46278.42,2022-02,taxes
2022-02-27 00:00:00+00:00,-1.32,46279.74,2022-02,transfer
2022-02-27 00:00:00+00:00,89.74,46190.0,2022-02,transfer
2022-02-27 00:00:00+00:00,15.86,46174.14,2022-02,transfer
2022-02-27 00:00:00+00:00,-27.53,46201.67,2022-02,transport
2022-02-27 00:00:00+00:00,-2.99,46204.66,2022-02,finances
2022-02-27 00:00:00+00:00,-23.62,46228.28,2022-02,groceries / food spend
2022-02-27 00:00:00+00:00,-7.56,46235.84,2022-02,shopping
2022-02-25 00:00:00+00:00,70.0,46165.84,2022-02,transfer
2022-02-25 00:00:00+00:00,-17.71,46183.55,2022-02,entertainment
2022-02-25 00:00:00+00:00,-10.0,46193.55,2022-02,transfer
2022-02-25 00:00:00+00:00,-0.39,46193.94,2022-02,savings
2022-02-25 00:00:00+00:00,-6.67,46200.61,2022-02,shopping
2022-02-25 00:00:00+00:00,-0.5,46201.11,2022-02,savings
2022-02-25 00:00:00+00:00,-0.32,46201.43,2022-02,entertainment
2022-02-23 00:00:00+00:00,-27.91,46229.34,2022-02,finances
2022-02-23 00:00:00+00:00,32.5,46196.84,2022-02,transfer
2022-02-23 00:00:00+00:00,-62.12,46258.96,2022-02,transfer
2022-02-23 00:00:00+00:00,-1.53,46260.49,2022-02,savings
2022-02-23 00:00:00+00:00,-16.88,46277.37,2022-02,transfer
2022-02-22 00:00:00+00:00,-5.0,46282.37,2022-02,shopping
2022-02-22 00:00:00+00:00,-0.01,46282.38,2022-02,savings
2022-02-22 00:00:00+00:00,-40.34,46322.72,2022-02,bills and utilities
2022-02-22 00:00:00+00:00,-78.89,46401.61,2022-02,shopping
2022-02-22 00:00:00+00:00,-36.59,46438.2,2022-02,finances
2022-02-20 00:00:00+00:00,-150.0,46588.2,2022-02,rent
2022-02-20 00:00:00+00:00,22.42,46565.78,2022-02,taxes
2022-02-20 00:00:00+00:00,-393.06,46958.84,2022-02,business services
2022-02-20 00:00:00+00:00,345.13,46613.71,2022-02,taxes
2022-02-19 00:00:00+00:00,-7.99,46621.7,2022-02,shopping
2022-02-19 00:00:00+00:00,1450.42,45171.28,2022-02,salary
2022-02-18 00:00:00+00:00,57.92,45113.36,2022-02,finances
2022-02-17 00:00:00+00:00,22.37,45090.99,2022-02,transfer
2022-02-17 00:00:00+00:00,-11.5,45102.49,2022-02,finances
2022-02-17 00:00:00+00:00,-19.42,45121.91,2022-02,finances
2022-02-17 00:00:00+00:00,-29.63,45151.54,2022-02,transport
2022-02-17 00:00:00+00:00,-0.63,45152.17,2022-02,savings
2022-02-17 00:00:00+00:00,-6.37,45158.54,2022-02,groceries / food spend
2022-02-15 00:00:00+00:00,-29.93,45188.47,2022-02,groceries / food spend
2022-02-15 00:00:00+00:00,-0.55,45189.02,2022-02,savings
2022-02-15 00:00:00+00:00,-29.76,45218.78,2022-02,shopping
2022-02-15 00:00:00+00:00,-0.5,45219.28,2022-02,savings
2022-02-15 00:00:00+00:00,-3.31,45222.59,2022-02,shopping
2022-02-15 00:00:00+00:00,-25.19,45247.78,2022-02,shopping
2022-02-14 00:00:00+00:00,-2.66,45250.44,2022-02,entertainment
2022-02-14 00:00:00+00:00,-20.5,45270.94,2022-02,entertainment
2022-02-14 00:00:00+00:00,43.5,45227.44,2022-02,entertainment
2022-02-12 00:00:00+00:00,-0.47,45227.91,2022-02,savings
2022-02-12 00:00:00+00:00,-34.57,45262.48,2022-02,transport
2022-02-11 00:00:00+00:00,55.06,45207.42,2022-02,finances
2022-02-11 00:00:00+00:00,73.5,45133.92,2022-02,transfer
2022-02-11 00:00:00+00:00,21.95,45111.97,2022-02,taxes
2022-02-11 00:00:00+00:00,-17.0,45128.97,2022-02,holidays
2022-02-10 00:00:00+00:00,-40.0,45168.97,2022-02,finances
2022-02-10 00:00:00+00:00,-5.0,45173.97,2022-02,groceries / food spend
2022-02-10 00:00:00+00:00,59.77,45114.2,2022-02,transfer
2022-02-10 00:00:00+00:00,50.36,45063.84,2022-02,finances
2022-02-10 00:00:00+00:00,-30.0,45093.84,2022-02,transfer
2022-02-10 00:00:00+00:00,-24.5,45118.34,2022-02,bills and utilities
2022-02-09 00:00:00+00:00,-23.62,45141.96,2022-02,transport
2022-02-09 00:00:00+00:00,-20.8,45162.76,2022-02,taxes
2022-02-09 00:00:00+00:00,-0.41,45163.17,2022-02,savings
2022-02-09 00:00:00+00:00,70.0,45093.17,2022-02,transfer
2022-02-08 00:00:00+00:00,-0.01,45093.18,2022-02,savings
2022-02-08 00:00:00+00:00,22.42,45070.76,2022-02,taxes
2022-02-08 00:00:00+00:00,-3.39,45074.15,2022-02,fees and charges
2022-02-08 00:00:00+00:00,-100.0,45174.15,2022-02,rent
2022-02-08 00:00:00+00:00,-10.0,45184.15,2022-02,entertainment
2022-02-08 00:00:00+00:00,-0.69,45184.84,2022-02,savings
2022-02-08 00:00:00+00:00,-1.04,45185.88,2022-02,savings
2022-02-08 00:00:00+00:00,-24.31,45210.19,2022-02,groceries / food spend
2022-02-07 00:00:00+00:00,-80.93,45291.12,2022-02,bills and utilities
2022-02-07 00:00:00+00:00,-1.15,45292.27,2022-02,savings
2022-02-07 00:00:00+00:00,-28.33,45320.6,2022-02,transfer
2022-02-06 00:00:00+00:00,-24.51,45345.11,2022-02,bills and utilities
2022-02-06 00:00:00+00:00,22.42,45322.69,2022-02,taxes
2022-02-06 00:00:00+00:00,-5.28,45327.97,2022-02,groceries / food spend
2022-02-06 00:00:00+00:00,-50.0,45377.97,2022-02,bills and utilities
2022-02-06 00:00:00+00:00,-9.71,45387.68,2022-02,home and garden
2022-02-06 00:00:00+00:00,346.35,45041.33,2022-02,taxes
2022-02-06 00:00:00+00:00,311.88,44729.45,2022-02,transfer
2022-02-06 00:00:00+00:00,61.89,44667.56,2022-02,transfer
2022-02-06 00:00:00+00:00,-0.01,44667.57,2022-02,savings
2022-02-06 00:00:00+00:00,-6.35,44673.92,2022-02,shopping
2022-02-05 00:00:00+00:00,-29.45,44703.37,2022-02,transfer
2022-02-05 00:00:00+00:00,-1.89,44705.26,2022-02,savings
2022-02-05 00:00:00+00:00,-7.33,44712.59,2022-02,finances
2022-02-05 00:00:00+00:00,-8.59,44721.18,2022-02,shopping
2022-02-05 00:00:00+00:00,-2.25,44723.43,2022-02,transfer
2022-02-05 00:00:00+00:00,-12.73,44736.16,2022-02,finances
2022-02-05 00:00:00+00:00,-4.68,44740.84,2022-02,groceries / food spend
2022-02-05 00:00:00+00:00,-20.0,44760.84,2022-02,shopping
2022-02-04 00:00:00+00:00,10.0,44750.84,2022-02,transfer
2022-02-04 00:00:00+00:00,70.0,44680.84,2022-02,transfer
2022-02-04 00:00:00+00:00,93.94,44586.9,2022-02,transfer
2022-02-04 00:00:00+00:00,-20.0,44606.9,2022-02,transfer
2022-02-04 00:00:00+00:00,-5.0,44611.9,2022-02,shopping
2022-02-04 00:00:00+00:00,-3.33,44615.23,2022-02,finances
2022-02-04 00:00:00+00:00,-205.59,44820.82,2022-02,transfer
2022-02-04 00:00:00+00:00,100.56,44720.26,2022-02,transfer
2022-02-04 00:00:00+00:00,-3.59,44723.85,2022-02,business services
2022-02-04 00:00:00+00:00,25.0,44698.85,2022-02,transfer
2022-02-04 00:00:00+00:00,-130.0,44828.85,2022-02,rent
2022-02-03 00:00:00+00:00,0.89,44827.96,2022-02,transfer
2022-02-03 00:00:00+00:00,-0.41,44828.37,2022-02,savings
2022-02-03 00:00:00+00:00,130.0,44698.37,2022-02,transfer
2022-02-03 00:00:00+00:00,7.0,44691.37,2022-02,transfer
2022-02-03 00:00:00+00:00,-25.0,44716.37,2022-02,transport
2022-02-03 00:00:00+00:00,35.49,44680.88,2022-02,entertainment
2022-02-03 00:00:00+00:00,-0.01,44680.89,2022-02,savings
2022-02-03 00:00:00+00:00,-3.79,44684.68,2022-02,entertainment
2022-02-03 00:00:00+00:00,-30.0,44714.68,2022-02,shopping
2022-02-03 00:00:00+00:00,40.0,44674.68,2022-02,transfer
2022-02-03 00:00:00+00:00,-50.46,44725.14,2022-02,transfer
2022-02-03 00:00:00+00:00,-5.0,44730.14,2022-02,groceries / food spend
2022-02-02 00:00:00+00:00,24.32,44705.82,2022-02,transfer
2022-02-02 00:00:00+00:00,-65.38,44771.2,2022-02,transfer
2022-02-02 00:00:00+00:00,19.85,44751.35,2022-02,transfer
2022-02-02 00:00:00+00:00,-0.65,44752.0,2022-02,savings
2022-02-01 00:00:00+00:00,-46.82,44798.82,2022-02,bills and utilities
2022-02-01 00:00:00+00:00,-0.01,44798.83,2022-02,fees and charges
2022-02-01 00:00:00+00:00,-227.0,45025.83,2022-02,transfer
2022-02-01 00:00:00+00:00,-54.94,45080.77,2022-02,groceries / food spend
2022-02-01 00:00:00+00:00,-0.01,45080.78,2022-02,finances
2022-02-01 00:00:00+00:00,-0.01,45080.79,2022-02,shopping
2022-02-01 00:00:00+00:00,-0.01,45080.8,2022-02,shopping
2022-02-01 00:00:00+00:00,-0.01,45080.81,2022-02,groceries / food spend
2022-02-01 00:00:00+00:00,-0.02,45080.83,2022-02,groceries / food spend
2022-02-01 00:00:00+00:00,-0.01,45080.84,2022-02,groceries / food spend
2022-02-01 00:00:00+00:00,-0.01,45080.85,2022-02,groceries / food spend
2022-02-01 00:00:00+00:00,-0.01,45080.86,2022-02,transport
2022-02-01 00:00:00+00:00,-265.04,45345.9,2022-02,restaurants / eating out / delivery
2022-02-01 00:00:00+00:00,-0.02,45345.92,2022-02,home and garden
2022-02-01 00:00:00+00:00,-0.01,45345.93,2022-02,fees and charges
2022-02-01 00:00:00+00:00,-0.01,45345.94,2022-02,transport
2022-02-01 00:00:00+00:00,0.0,45345.94,2022-02,entertainment
2022-02-01 00:00:00+00:00,-0.01,45345.95,2022-02,fees and charges
2022-02-01 00:00:00+00:00,-23.99,45369.94,2022-02,groceries / food spend
2022-02-01 00:00:00+00:00,-21.87,45391.81,2022-02,transfer
2022-02-01 00:00:00+00:00,-7.74,45399.55,2022-02,business services
2022-02-01 00:00:00+00:00,-10.0,45409.55,2022-02,bills and utilities
2022-02-01 00:00:00+00:00,-10.0,45419.55,2022-02,finances
2022-02-01 00:00:00+00:00,-13.62,45433.17,2022-02,finances
2022-02-01 00:00:00+00:00,-8.49,45441.66,2022-02,bills and utilities
2022-01-28 00:00:00+00:00,702.98,44738.68,2022-01,transfer
2022-01-28 00:00:00+00:00,-36.59,44775.27,2022-01,shopping
2022-01-28 00:00:00+00:00,12.54,44762.73,2022-01,transfer
2022-01-28 00:00:00+00:00,-32.72,44795.45,2022-01,transfer
2022-01-28 00:00:00+00:00,22.42,44773.03,2022-01,taxes
2022-01-27 00:00:00+00:00,-9.92,44782.95,2022-01,transfer
2022-01-27 00:00:00+00:00,21.34,44761.61,2022-01,transfer
2022-01-27 00:00:00+00:00,15.86,44745.75,2022-01,transfer
2022-01-27 00:00:00+00:00,-20.56,44766.31,2022-01,transport
2022-01-27 00:00:00+00:00,-3.07,44769.38,2022-01,finances
2022-01-27 00:00:00+00:00,-23.62,44793.0,2022-01,groceries / food spend
2022-01-27 00:00:00+00:00,-0.2,44793.2,2022-01,shopping
2022-01-25 00:00:00+00:00,99.67,44693.53,2022-01,transfer
2022-01-25 00:00:00+00:00,-18.29,44711.82,2022-01,entertainment
2022-01-25 00:00:00+00:00,-10.0,44721.82,2022-01,transfer
2022-01-25 00:00:00+00:00,-0.41,44722.23,2022-01,savings
2022-01-25 00:00:00+00:00,-36.59,44758.82,2022-01,shopping
2022-01-25 00:00:00+00:00,-0.47,44759.29,2022-01,savings
2022-01-25 00:00:00+00:00,-1.12,44760.41,2022-01,entertainment
2022-01-23 00:00:00+00:00,-49.58,44809.99,2022-01,finances
2022-01-23 00:00:00+00:00,40.53,44769.46,2022-01,transfer
2022-01-23 00:00:00+00:00,-127.3,44896.76,2022-01,transfer
2022-01-23 00:00:00+00:00,-1.59,44898.35,2022-01,savings
2022-01-23 00:00:00+00:00,-27.12,44925.47,2022-01,transfer
2022-01-22 00:00:00+00:00,-8.22,44933.69,2022-01,shopping
2022-01-22 00:00:00+00:00,-0.01,44933.7,2022-01,savings
2022-01-22 00:00:00+00:00,-39.25,44972.95,2022-01,bills and utilities
2022-01-22 00:00:00+00:00,-59.57,45032.52,2022-01,shopping
2022-01-22 00:00:00+00:00,-36.59,45069.11,2022-01,finances
2022-01-20 00:00:00+00:00,-150.0,45219.11,2022-01,rent
2022-01-20 00:00:00+00:00,22.42,45196.69,2022-01,taxes
2022-01-20 00:00:00+00:00,-472.29,45668.98,2022-01,business services
2022-01-20 00:00:00+00:00,348.08,45320.9,2022-01,taxes
2022-01-19 00:00:00+00:00,-5.37,45326.27,2022-01,shopping
2022-01-19 00:00:00+00:00,1450.42,43875.85,2022-01,salary
2022-01-18 00:00:00+00:00,82.21,43793.64,2022-01,finances
2022-01-17 00:00:00+00:00,93.39,43700.25,2022-01,transfer
2022-01-17 00:00:00+00:00,-12.73,43712.98,2022-01,finances
2022-01-17 00:00:00+00:00,-50.05,43763.03,2022-01,finances
2022-01-17 00:00:00+00:00,-20.0,43783.03,2022-01,transport
2022-01-17 00:00:00+00:00,-0.66,43783.69,2022-01,savings
2022-01-17 00:00:00+00:00,-6.37,43790.06,2022-01,groceries / food spend
2022-01-15 00:00:00+00:00,-32.0,43822.06,2022-01,groceries / food spend
2022-01-15 00:00:00+00:00,-0.54,43822.6,2022-01,savings
2022-01-15 00:00:00+00:00,-21.12,43843.72,2022-01,shopping
2022-01-15 00:00:00+00:00,-0.5,43844.22,2022-01,savings
2022-01-15 00:00:00+00:00,1.0,43843.22,2022-01,shopping
2022-01-15 00:00:00+00:00,-8.58,43851.8,2022-01,shopping
2022-01-14 00:00:00+00:00,-1.55,43853.35,2022-01,entertainment
2022-01-14 00:00:00+00:00,-44.21,43897.56,2022-01,entertainment
2022-01-14 00:00:00+00:00,43.5,43854.06,2022-01,entertainment
2022-01-12 00:00:00+00:00,-0.41,43854.47,2022-01,savings
2022-01-12 00:00:00+00:00,-24.44,43878.91,2022-01,transport
2022-01-11 00:00:00+00:00,50.0,43828.91,2022-01,finances
2022-01-11 00:00:00+00:00,50.0,43778.91,2022-01,transfer
2022-01-11 00:00:00+00:00,22.42,43756.49,2022-01,taxes
2022-01-11 00:00:00+00:00,8.64,43747.85,2022-01,holidays
2022-01-10 00:00:00+00:00,-40.0,43787.85,2022-01,finances
2022-01-10 00:00:00+00:00,-5.0,43792.85,2022-01,groceries / food spend
2022-01-10 00:00:00+00:00,40.0,43752.85,2022-01,transfer
2022-01-10 00:00:00+00:00,50.36,43702.49,2022-01,finances
2022-01-10 00:00:00+00:00,-30.0,43732.49,2022-01,transfer
2022-01-10 00:00:00+00:00,-24.5,43756.99,2022-01,bills and utilities
2022-01-09 00:00:00+00:00,-23.62,43780.61,2022-01,transport
2022-01-09 00:00:00+00:00,-20.56,43801.17,2022-01,taxes
2022-01-09 00:00:00+00:00,-0.41,43801.58,2022-01,savings
2022-01-09 00:00:00+00:00,54.63,43746.95,2022-01,transfer
2022-01-08 00:00:00+00:00,-0.01,43746.96,2022-01,savings
2022-01-08 00:00:00+00:00,22.42,43724.54,2022-01,taxes
2022-01-08 00:00:00+00:00,-11.81,43736.35,2022-01,fees and charges
2022-01-08 00:00:00+00:00,-100.0,43836.35,2022-01,rent
2022-01-08 00:00:00+00:00,-10.0,43846.35,2022-01,entertainment
2022-01-08 00:00:00+00:00,-0.75,43847.1,2022-01,savings
2022-01-08 00:00:00+00:00,-1.04,43848.14,2022-01,savings
2022-01-08 00:00:00+00:00,-9.31,43857.45,2022-01,groceries / food spend
2022-01-07 00:00:00+00:00,-90.56,43948.01,2022-01,bills and utilities
2022-01-07 00:00:00+00:00,-1.15,43949.16,2022-01,savings
2022-01-07 00:00:00+00:00,-70.0,44019.16,2022-01,transfer
2022-01-06 00:00:00+00:00,-28.25,44047.41,2022-01,bills and utilities
2022-01-06 00:00:00+00:00,21.55,44025.86,2022-01,taxes
2022-01-06 00:00:00+00:00,-2.17,44028.03,2022-01,groceries / food spend
2022-01-06 00:00:00+00:00,-48.71,44076.74,2022-01,bills and utilities
2022-01-06 00:00:00+00:00,-9.66,44086.4,2022-01,home and garden
2022-01-06 00:00:00+00:00,340.19,43746.21,2022-01,taxes
2022-01-06 00:00:00+00:00,137.6,43608.61,2022-01,transfer
2022-01-06 00:00:00+00:00,61.89,43546.72,2022-01,transfer
2022-01-06 00:00:00+00:00,-0.01,43546.73,2022-01,savings
2022-01-06 00:00:00+00:00,-7.78,43554.51,2022-01,shopping
2022-01-05 00:00:00+00:00,-76.27,43630.78,2022-01,transfer
2022-01-05 00:00:00+00:00,-1.89,43632.67,2022-01,savings
2022-01-05 00:00:00+00:00,-6.33,43639.0,2022-01,finances
2022-01-05 00:00:00+00:00,-7.99,43646.99,2022-01,shopping
2022-01-05 00:00:00+00:00,-23.15,43670.14,2022-01,transfer
2022-01-05 00:00:00+00:00,-12.73,43682.87,2022-01,finances
2022-01-05 00:00:00+00:00,-0.24,43683.11,2022-01,groceries / food spend
2022-01-05 00:00:00+00:00,-30.76,43713.87,2022-01,shopping
2022-01-04 00:00:00+00:00,12.69,43701.18,2022-01,transfer
2022-01-04 00:00:00+00:00,70.0,43631.18,2022-01,transfer
2022-01-04 00:00:00+00:00,59.17,43572.01,2022-01,transfer
2022-01-04 00:00:00+00:00,-20.0,43592.01,2022-01,transfer
2022-01-04 00:00:00+00:00,-5.0,43597.01,2022-01,shopping
2022-01-04 00:00:00+00:00,-3.15,43600.16,2022-01,finances
2022-01-04 00:00:00+00:00,-104.91,43705.07,2022-01,transfer
2022-01-04 00:00:00+00:00,100.0,43605.07,2022-01,transfer
2022-01-04 00:00:00+00:00,-7.71,43612.78,2022-01,business services
2022-01-04 00:00:00+00:00,25.0,43587.78,2022-01,transfer
2022-01-04 00:00:00+00:00,-130.0,43717.78,2022-01,rent
2022-01-03 00:00:00+00:00,1.22,43716.56,2022-01,transfer
2022-01-03 00:00:00+00:00,-0.45,43717.01,2022-01,savings
2022-01-03 00:00:00+00:00,189.68,43527.33,2022-01,transfer
2022-01-03 00:00:00+00:00,11.95,43515.38,2022-01,transfer
2022-01-03 00:00:00+00:00,-23.11,43538.49,2022-01,transport
2022-01-03 00:00:00+00:00,35.49,43503.0,2022-01,entertainment
2022-01-03 00:00:00+00:00,-0.01,43503.01,2022-01,savings
2022-01-03 00:00:00+00:00,-2.99,43506.0,2022-01,entertainment
2022-01-03 00:00:00+00:00,-2.15,43508.15,2022-01,shopping
2022-01-03 00:00:00+00:00,40.0,43468.15,2022-01,transfer
2022-01-03 00:00:00+00:00,-37.07,43505.22,2022-01,transfer
2022-01-03 00:00:00+00:00,-2.05,43507.27,2022-01,groceries / food spend
2022-01-02 00:00:00+00:00,29.94,43477.33,2022-01,transfer
2022-01-02 00:00:00+00:00,-30.0,43507.33,2022-01,transfer
2022-01-02 00:00:00+00:00,20.65,43486.68,2022-01,transfer
2022-01-02 00:00:00+00:00,-0.63,43487.31,2022-01,savings
2022-01-01 00:00:00+00:00,-46.82,43534.13,2022-01,bills and utilities
2022-01-01 00:00:00+00:00,-0.01,43534.14,2022-01,fees and charges
2022-01-01 00:00:00+00:00,-227.0,43761.14,2022-01,transfer
2022-01-01 00:00:00+00:00,-39.99,43801.13,2022-01,groceries / food spend
2022-01-01 00:00:00+00:00,-0.01,43801.14,2022-01,finances
2022-01-01 00:00:00+00:00,-0.03,43801.17,2022-01,shopping
2022-01-01 00:00:00+00:00,-0.01,43801.18,2022-01,shopping
2022-01-01 00:00:00+00:00,-0.0,43801.18,2022-01,groceries / food spend
2022-01-01 00:00:00+00:00,-0.01,43801.19,2022-01,groceries / food spend
2022-01-01 00:00:00+00:00,-0.01,43801.2,2022-01,groceries / food spend
2022-01-01 00:00:00+00:00,-0.01,43801.21,2022-01,groceries / food spend
2022-01-01 00:00:00+00:00,-0.01,43801.22,2022-01,transport
2022-01-01 00:00:00+00:00,-292.52,44093.74,2022-01,restaurants / eating out / delivery
2022-01-01 00:00:00+00:00,-0.01,44093.75,2022-01,home and garden
2022-01-01 00:00:00+00:00,-0.01,44093.76,2022-01,fees and charges
2022-01-01 00:00:00+00:00,-0.01,44093.77,2022-01,transport
2022-01-01 00:00:00+00:00,-0.01,44093.78,2022-01,entertainment
2022-01-01 00:00:00+00:00,-0.0,44093.78,2022-01,fees and charges
2022-01-01 00:00:00+00:00,-44.13,44137.91,2022-01,groceries / food spend
2022-01-01 00:00:00+00:00,-20.91,44158.82,2022-01,transfer
2022-01-01 00:00:00+00:00,-12.41,44171.23,2022-01,business services
2022-01-01 00:00:00+00:00,-12.43,44183.66,2022-01,bills and utilities
2022-01-01 00:00:00+00:00,-10.0,44193.66,2022-01,finances
2022-01-01 00:00:00+00:00,-11.01,44204.67,2022-01,finances
2022-01-01 00:00:00+00:00,-9.6,44214.27,2022-01,bills and utilities
2021-12-28 00:00:00+00:00,420.0,43794.27,2021-12,transfer
2021-12-28 00:00:00+00:00,-36.59,43830.86,2021-12,shopping
2021-12-28 00:00:00+00:00,40.0,43790.86,2021-12,transfer
2021-12-28 00:00:00+00:00,-32.72,43823.58,2021-12,transfer
2021-12-28 00:00:00+00:00,22.58,43801.0,2021-12,taxes
2021-12-27 00:00:00+00:00,-7.93,43808.93,2021-12,transfer
2021-12-27 00:00:00+00:00,84.41,43724.52,2021-12,transfer
2021-12-27 00:00:00+00:00,32.4,43692.12,2021-12,transfer
2021-12-27 00:00:00+00:00,-20.56,43712.68,2021-12,transport
2021-12-27 00:00:00+00:00,-2.99,43715.67,2021-12,finances
2021-12-27 00:00:00+00:00,-23.62,43739.29,2021-12,groceries / food spend
2021-12-27 00:00:00+00:00,-7.56,43746.85,2021-12,shopping
2021-12-25 00:00:00+00:00,24.68,43722.17,2021-12,transfer
2021-12-25 00:00:00+00:00,-31.26,43753.43,2021-12,entertainment
2021-12-25 00:00:00+00:00,-6.23,43759.66,2021-12,transfer
2021-12-25 00:00:00+00:00,-0.4,43760.06,2021-12,savings
2021-12-25 00:00:00+00:00,-31.24,43791.3,2021-12,shopping
2021-12-25 00:00:00+00:00,-0.4,43791.7,2021-12,savings
2021-12-25 00:00:00+00:00,-10.5,43802.2,2021-12,entertainment
2021-12-23 00:00:00+00:00,-30.0,43832.2,2021-12,finances
2021-12-23 00:00:00+00:00,32.5,43799.7,2021-12,transfer
2021-12-23 00:00:00+00:00,-106.13,43905.83,2021-12,transfer
2021-12-23 00:00:00+00:00,-1.57,43907.4,2021-12,savings
2021-12-23 00:00:00+00:00,-33.64,43941.04,2021-12,transfer
2021-12-22 00:00:00+00:00,-1.4,43942.44,2021-12,shopping
2021-12-22 00:00:00+00:00,-0.01,43942.45,2021-12,savings
2021-12-22 00:00:00+00:00,-40.71,43983.16,2021-12,bills and utilities
2021-12-22 00:00:00+00:00,-36.59,44019.75,2021-12,shopping
2021-12-22 00:00:00+00:00,-36.59,44056.34,2021-12,finances
2021-12-20 00:00:00+00:00,-150.0,44206.34,2021-12,rent
2021-12-20 00:00:00+00:00,23.02,44183.32,2021-12,taxes
2021-12-20 00:00:00+00:00,-550.0,44733.32,2021-12,business services
2021-12-20 00:00:00+00:00,345.13,44388.19,2021-12,taxes
2021-12-19 00:00:00+00:00,-7.99,44396.18,2021-12,shopping
2021-12-19 00:00:00+00:00,1450.42,42945.76,2021-12,salary
2021-12-18 00:00:00+00:00,82.21,42863.55,2021-12,finances
2021-12-17 00:00:00+00:00,137.6,42725.95,2021-12,transfer
2021-12-17 00:00:00+00:00,-12.73,42738.68,2021-12,finances
2021-12-17 00:00:00+00:00,-35.02,42773.7,2021-12,finances
2021-12-17 00:00:00+00:00,-31.63,42805.33,2021-12,transport
2021-12-17 00:00:00+00:00,-0.68,42806.01,2021-12,savings
2021-12-17 00:00:00+00:00,-2.4,42808.41,2021-12,groceries / food spend
2021-12-15 00:00:00+00:00,-30.78,42839.19,2021-12,groceries / food spend
2021-12-15 00:00:00+00:00,-0.53,42839.72,2021-12,savings
2021-12-15 00:00:00+00:00,-15.45,42855.17,2021-12,shopping
2021-12-15 00:00:00+00:00,-0.5,42855.67,2021-12,savings
2021-12-15 00:00:00+00:00,-3.59,42859.26,2021-12,shopping
2021-12-15 00:00:00+00:00,5.16,42854.1,2021-12,shopping
2021-12-14 00:00:00+00:00,-2.0,42856.1,2021-12,entertainment
2021-12-14 00:00:00+00:00,-20.5,42876.6,2021-12,entertainment
2021-12-14 00:00:00+00:00,43.5,42833.1,2021-12,entertainment
2021-12-12 00:00:00+00:00,-0.41,42833.51,2021-12,savings
2021-12-12 00:00:00+00:00,-23.11,42856.62,2021-12,transport
2021-12-11 00:00:00+00:00,60.68,42795.94,2021-12,finances
2021-12-11 00:00:00+00:00,67.15,42728.79,2021-12,transfer
2021-12-11 00:00:00+00:00,21.44,42707.35,2021-12,taxes
2021-12-11 00:00:00+00:00,5.04,42702.31,2021-12,holidays
2021-12-10 00:00:00+00:00,-40.0,42742.31,2021-12,finances
2021-12-10 00:00:00+00:00,-0.67,42742.98,2021-12,groceries / food spend
2021-12-10 00:00:00+00:00,36.93,42706.05,2021-12,transfer
2021-12-10 00:00:00+00:00,45.97,42660.08,2021-12,finances
2021-12-10 00:00:00+00:00,-30.0,42690.08,2021-12,transfer
2021-12-10 00:00:00+00:00,-22.7,42712.78,2021-12,bills and utilities
2021-12-09 00:00:00+00:00,-33.51,42746.29,2021-12,transport
2021-12-09 00:00:00+00:00,-20.83,42767.12,2021-12,taxes
2021-12-09 00:00:00+00:00,-0.47,42767.59,2021-12,savings
2021-12-09 00:00:00+00:00,72.5,42695.09,2021-12,transfer
2021-12-08 00:00:00+00:00,-0.01,42695.1,2021-12,savings
2021-12-08 00:00:00+00:00,23.93,42671.17,2021-12,taxes
2021-12-08 00:00:00+00:00,-14.99,42686.16,2021-12,fees and charges
2021-12-08 00:00:00+00:00,-100.0,42786.16,2021-12,rent
2021-12-08 00:00:00+00:00,-10.0,42796.16,2021-12,entertainment
2021-12-08 00:00:00+00:00,-0.69,42796.85,2021-12,savings
2021-12-08 00:00:00+00:00,-0.92,42797.77,2021-12,savings
2021-12-08 00:00:00+00:00,-24.31,42822.08,2021-12,groceries / food spend
2021-12-07 00:00:00+00:00,-77.86,42899.94,2021-12,bills and utilities
2021-12-07 00:00:00+00:00,-1.29,42901.23,2021-12,savings
2021-12-07 00:00:00+00:00,-98.34,42999.57,2021-12,transfer
2021-12-06 00:00:00+00:00,-28.25,43027.82,2021-12,bills and utilities
2021-12-06 00:00:00+00:00,22.08,43005.74,2021-12,taxes
2021-12-06 00:00:00+00:00,-8.55,43014.29,2021-12,groceries / food spend
2021-12-06 00:00:00+00:00,-51.35,43065.64,2021-12,bills and utilities
2021-12-06 00:00:00+00:00,-8.01,43073.65,2021-12,home and garden
2021-12-06 00:00:00+00:00,384.84,42688.81,2021-12,taxes
2021-12-06 00:00:00+00:00,137.6,42551.21,2021-12,transfer
2021-12-06 00:00:00+00:00,61.89,42489.32,2021-12,transfer
2021-12-06 00:00:00+00:00,-0.01,42489.33,2021-12,savings
2021-12-06 00:00:00+00:00,-5.0,42494.33,2021-12,shopping
2021-12-05 00:00:00+00:00,-48.28,42542.61,2021-12,transfer
2021-12-05 00:00:00+00:00,-1.88,42544.49,2021-12,savings
2021-12-05 00:00:00+00:00,-5.79,42550.28,2021-12,finances
2021-12-05 00:00:00+00:00,-7.72,42558.0,2021-12,shopping
2021-12-05 00:00:00+00:00,-25.17,42583.17,2021-12,transfer
2021-12-05 00:00:00+00:00,-16.55,42599.72,2021-12,finances
2021-12-05 00:00:00+00:00,0.51,42599.21,2021-12,groceries / food spend
2021-12-05 00:00:00+00:00,-40.32,42639.53,2021-12,shopping
2021-12-04 00:00:00+00:00,13.16,42626.37,2021-12,transfer
2021-12-04 00:00:00+00:00,41.55,42584.82,2021-12,transfer
2021-12-04 00:00:00+00:00,47.78,42537.04,2021-12,transfer
2021-12-04 00:00:00+00:00,-20.0,42557.04,2021-12,transfer
2021-12-04 00:00:00+00:00,-1.58,42558.62,2021-12,shopping
2021-12-04 00:00:00+00:00,-3.69,42562.31,2021-12,finances
2021-12-04 00:00:00+00:00,-100.0,42662.31,2021-12,transfer
2021-12-04 00:00:00+00:00,124.83,42537.48,2021-12,transfer
2021-12-04 00:00:00+00:00,-4.52,42542.0,2021-12,business services
2021-12-04 00:00:00+00:00,29.32,42512.68,2021-12,transfer
2021-12-04 00:00:00+00:00,-130.0,42642.68,2021-12,rent
2021-12-03 00:00:00+00:00,0.89,42641.79,2021-12,transfer
2021-12-03 00:00:00+00:00,-0.39,42642.18,2021-12,savings
2021-12-03 00:00:00+00:00,159.29,42482.89,2021-12,transfer
2021-12-03 00:00:00+00:00,7.0,42475.89,2021-12,transfer
2021-12-03 00:00:00+00:00,-12.8,42488.69,2021-12,transport
2021-12-03 00:00:00+00:00,30.98,42457.71,2021-12,entertainment
2021-12-03 00:00:00+00:00,-0.01,42457.72,2021-12,savings
2021-12-03 00:00:00+00:00,-2.99,42460.71,2021-12,entertainment
2021-12-03 00:00:00+00:00,-30.0,42490.71,2021-12,shopping
2021-12-03 00:00:00+00:00,33.16,42457.55,2021-12,transfer
2021-12-03 00:00:00+00:00,-40.0,42497.55,2021-12,transfer
2021-12-03 00:00:00+00:00,-6.92,42504.47,2021-12,groceries / food spend
2021-12-02 00:00:00+00:00,30.0,42474.47,2021-12,transfer
2021-12-02 00:00:00+00:00,-30.0,42504.47,2021-12,transfer
2021-12-02 00:00:00+00:00,19.97,42484.5,2021-12,transfer
2021-12-02 00:00:00+00:00,-0.59,42485.09,2021-12,savings
2021-12-01 00:00:00+00:00,-48.52,42533.61,2021-12,bills and utilities
2021-12-01 00:00:00+00:00,-0.01,42533.62,2021-12,fees and charges
2021-12-01 00:00:00+00:00,-212.75,42746.37,2021-12,transfer
2021-12-01 00:00:00+00:00,-39.99,42786.36,2021-12,groceries / food spend
2021-12-01 00:00:00+00:00,-0.01,42786.37,2021-12,finances
2021-12-01 00:00:00+00:00,-0.01,42786.38,2021-12,shopping
2021-12-01 00:00:00+00:00,-0.01,42786.39,2021-12,shopping
2021-12-01 00:00:00+00:00,-0.01,42786.4,2021-12,groceries / food spend
2021-12-01 00:00:00+00:00,-0.0,42786.4,2021-12,groceries / food spend
2021-12-01 00:00:00+00:00,-0.01,42786.41,2021-12,groceries / food spend
2021-12-01 00:00:00+00:00,-0.01,42786.42,2021-12,groceries / food spend
2021-12-01 00:00:00+00:00,-0.01,42786.43,2021-12,transport
2021-12-01 00:00:00+00:00,-250.39,43036.82,2021-12,restaurants / eating out / delivery
2021-12-01 00:00:00+00:00,-0.01,43036.83,2021-12,home and garden
2021-12-01 00:00:00+00:00,-0.01,43036.84,2021-12,fees and charges
2021-12-01 00:00:00+00:00,-0.01,43036.85,2021-12,transport
2021-12-01 00:00:00+00:00,-0.01,43036.86,2021-12,entertainment
2021-12-01 00:00:00+00:00,-0.01,43036.87,2021-12,fees and charges
2021-12-01 00:00:00+00:00,-23.99,43060.86,2021-12,groceries / food spend
2021-12-01 00:00:00+00:00,-20.91,43081.77,2021-12,transfer
2021-12-01 00:00:00+00:00,-9.15,43090.92,2021-12,business services
2021-12-01 00:00:00+00:00,-10.0,43100.92,2021-12,bills and utilities
2021-12-01 00:00:00+00:00,-10.0,43110.92,2021-12,finances
2021-12-01 00:00:00+00:00,-10.71,43121.63,2021-12,finances
2021-12-01 00:00:00+00:00,-11.23,43132.86,2021-12,bills and utilities
2021-11-28 00:00:00+00:00,420.0,42712.86,2021-11,transfer
2021-11-28 00:00:00+00:00,-36.59,42749.45,2021-11,shopping
2021-11-28 00:00:00+00:00,40.0,42709.45,2021-11,transfer
2021-11-28 00:00:00+00:00,-32.72,42742.17,2021-11,transfer
2021-11-28 00:00:00+00:00,22.42,42719.75,2021-11,taxes
2021-11-27 00:00:00+00:00,-8.05,42727.8,2021-11,transfer
2021-11-27 00:00:00+00:00,30.24,42697.56,2021-11,transfer
2021-11-27 00:00:00+00:00,27.63,42669.93,2021-11,transfer
2021-11-27 00:00:00+00:00,-21.72,42691.65,2021-11,transport
2021-11-27 00:00:00+00:00,-2.99,42694.64,2021-11,finances
2021-11-27 00:00:00+00:00,-23.17,42717.81,2021-11,groceries / food spend
2021-11-27 00:00:00+00:00,-5.09,42722.9,2021-11,shopping
2021-11-25 00:00:00+00:00,60.42,42662.48,2021-11,transfer
2021-11-25 00:00:00+00:00,-24.5,42686.98,2021-11,entertainment
2021-11-25 00:00:00+00:00,-10.0,42696.98,2021-11,transfer
2021-11-25 00:00:00+00:00,-0.45,42697.43,2021-11,savings
2021-11-25 00:00:00+00:00,-36.59,42734.02,2021-11,shopping
2021-11-25 00:00:00+00:00,-0.43,42734.45,2021-11,savings
2021-11-25 00:00:00+00:00,-10.5,42744.95,2021-11,entertainment
2021-11-23 00:00:00+00:00,-30.0,42774.95,2021-11,finances
2021-11-23 00:00:00+00:00,38.5,42736.45,2021-11,transfer
2021-11-23 00:00:00+00:00,-138.38,42874.83,2021-11,transfer
2021-11-23 00:00:00+00:00,-1.57,42876.4,2021-11,savings
2021-11-23 00:00:00+00:00,-20.0,42896.4,2021-11,transfer
2021-11-22 00:00:00+00:00,-3.96,42900.36,2021-11,shopping
2021-11-22 00:00:00+00:00,-0.01,42900.37,2021-11,savings
2021-11-22 00:00:00+00:00,-45.56,42945.93,2021-11,bills and utilities
2021-11-22 00:00:00+00:00,-40.13,42986.06,2021-11,shopping
2021-11-22 00:00:00+00:00,-38.96,43025.02,2021-11,finances
2021-11-20 00:00:00+00:00,-150.0,43175.02,2021-11,rent
2021-11-20 00:00:00+00:00,21.47,43153.55,2021-11,taxes
2021-11-20 00:00:00+00:00,-603.49,43757.04,2021-11,business services
2021-11-20 00:00:00+00:00,345.13,43411.91,2021-11,taxes
2021-11-19 00:00:00+00:00,-7.99,43419.9,2021-11,shopping
2021-11-19 00:00:00+00:00,1450.42,41969.48,2021-11,salary
2021-11-18 00:00:00+00:00,85.09,41884.39,2021-11,finances
2021-11-17 00:00:00+00:00,137.6,41746.79,2021-11,transfer
2021-11-17 00:00:00+00:00,-15.59,41762.38,2021-11,finances
2021-11-17 00:00:00+00:00,-34.03,41796.41,2021-11,finances
2021-11-17 00:00:00+00:00,-23.53,41819.94,2021-11,transport
2021-11-17 00:00:00+00:00,-0.63,41820.57,2021-11,savings
2021-11-17 00:00:00+00:00,-6.37,41826.94,2021-11,groceries / food spend
2021-11-15 00:00:00+00:00,-32.0,41858.94,2021-11,groceries / food spend
2021-11-15 00:00:00+00:00,-0.55,41859.49,2021-11,savings
2021-11-15 00:00:00+00:00,-15.45,41874.94,2021-11,shopping
2021-11-15 00:00:00+00:00,-0.5,41875.44,2021-11,savings
2021-11-15 00:00:00+00:00,-3.59,41879.03,2021-11,shopping
2021-11-15 00:00:00+00:00,-10.0,41889.03,2021-11,shopping
2021-11-14 00:00:00+00:00,-2.0,41891.03,2021-11,entertainment
2021-11-14 00:00:00+00:00,-20.5,41911.53,2021-11,entertainment
2021-11-14 00:00:00+00:00,9.85,41901.68,2021-11,entertainment
2021-11-12 00:00:00+00:00,-0.41,41902.09,2021-11,savings
2021-11-12 00:00:00+00:00,-23.11,41925.2,2021-11,transport
2021-11-11 00:00:00+00:00,50.0,41875.2,2021-11,finances
2021-11-11 00:00:00+00:00,50.0,41825.2,2021-11,transfer
2021-11-11 00:00:00+00:00,23.45,41801.75,2021-11,taxes
2021-11-11 00:00:00+00:00,-17.76,41819.51,2021-11,holidays
2021-11-10 00:00:00+00:00,-34.18,41853.69,2021-11,finances
2021-11-10 00:00:00+00:00,-5.0,41858.69,2021-11,groceries / food spend
2021-11-10 00:00:00+00:00,40.0,41818.69,2021-11,transfer
2021-11-10 00:00:00+00:00,50.61,41768.08,2021-11,finances
2021-11-10 00:00:00+00:00,-30.0,41798.08,2021-11,transfer
2021-11-10 00:00:00+00:00,-29.03,41827.11,2021-11,bills and utilities
2021-11-09 00:00:00+00:00,-23.62,41850.73,2021-11,transport
2021-11-09 00:00:00+00:00,-20.71,41871.44,2021-11,taxes
2021-11-09 00:00:00+00:00,-0.41,41871.85,2021-11,savings
2021-11-09 00:00:00+00:00,70.0,41801.85,2021-11,transfer
2021-11-08 00:00:00+00:00,-0.01,41801.86,2021-11,savings
2021-11-08 00:00:00+00:00,22.42,41779.44,2021-11,taxes
2021-11-08 00:00:00+00:00,-11.11,41790.55,2021-11,fees and charges
2021-11-08 00:00:00+00:00,-100.0,41890.55,2021-11,rent
2021-11-08 00:00:00+00:00,-14.35,41904.9,2021-11,entertainment
2021-11-08 00:00:00+00:00,-0.69,41905.59,2021-11,savings
2021-11-08 00:00:00+00:00,-1.04,41906.63,2021-11,savings
2021-11-08 00:00:00+00:00,-24.31,41930.94,2021-11,groceries / food spend
2021-11-07 00:00:00+00:00,-82.37,42013.31,2021-11,bills and utilities
2021-11-07 00:00:00+00:00,-1.15,42014.46,2021-11,savings
2021-11-07 00:00:00+00:00,-70.0,42084.46,2021-11,transfer
2021-11-06 00:00:00+00:00,-28.25,42112.71,2021-11,bills and utilities
2021-11-06 00:00:00+00:00,22.42,42090.29,2021-11,taxes
2021-11-06 00:00:00+00:00,-12.89,42103.18,2021-11,groceries / food spend
2021-11-06 00:00:00+00:00,-50.0,42153.18,2021-11,bills and utilities
2021-11-06 00:00:00+00:00,-19.01,42172.19,2021-11,home and garden
2021-11-06 00:00:00+00:00,342.29,41829.9,2021-11,taxes
2021-11-06 00:00:00+00:00,137.6,41692.3,2021-11,transfer
2021-11-06 00:00:00+00:00,7.66,41684.64,2021-11,transfer
2021-11-06 00:00:00+00:00,-0.01,41684.65,2021-11,savings
2021-11-06 00:00:00+00:00,-5.0,41689.65,2021-11,shopping
2021-11-05 00:00:00+00:00,-44.98,41734.63,2021-11,transfer
2021-11-05 00:00:00+00:00,-1.68,41736.31,2021-11,savings
2021-11-05 00:00:00+00:00,-5.53,41741.84,2021-11,finances
2021-11-05 00:00:00+00:00,-7.99,41749.83,2021-11,shopping
2021-11-05 00:00:00+00:00,-28.9,41778.73,2021-11,transfer
2021-11-05 00:00:00+00:00,-11.16,41789.89,2021-11,finances
2021-11-05 00:00:00+00:00,-6.37,41796.26,2021-11,groceries / food spend
2021-11-05 00:00:00+00:00,-20.0,41816.26,2021-11,shopping
2021-11-04 00:00:00+00:00,7.33,41808.93,2021-11,transfer
2021-11-04 00:00:00+00:00,70.0,41738.93,2021-11,transfer
2021-11-04 00:00:00+00:00,59.17,41679.76,2021-11,transfer
2021-11-04 00:00:00+00:00,-10.96,41690.72,2021-11,transfer
2021-11-04 00:00:00+00:00,0.38,41690.34,2021-11,shopping
2021-11-04 00:00:00+00:00,-3.12,41693.46,2021-11,finances
2021-11-04 00:00:00+00:00,-154.73,41848.19,2021-11,transfer
2021-11-04 00:00:00+00:00,100.0,41748.19,2021-11,transfer
2021-11-04 00:00:00+00:00,-3.95,41752.14,2021-11,business services
2021-11-04 00:00:00+00:00,25.0,41727.14,2021-11,transfer
2021-11-04 00:00:00+00:00,-130.0,41857.14,2021-11,rent
2021-11-03 00:00:00+00:00,0.5,41856.64,2021-11,transfer
2021-11-03 00:00:00+00:00,-0.4,41857.04,2021-11,savings
2021-11-03 00:00:00+00:00,130.0,41727.04,2021-11,transfer
2021-11-03 00:00:00+00:00,8.08,41718.96,2021-11,transfer
2021-11-03 00:00:00+00:00,-15.16,41734.12,2021-11,transport
2021-11-03 00:00:00+00:00,50.58,41683.54,2021-11,entertainment
2021-11-03 00:00:00+00:00,-0.01,41683.55,2021-11,savings
2021-11-03 00:00:00+00:00,-2.99,41686.54,2021-11,entertainment
2021-11-03 00:00:00+00:00,-30.0,41716.54,2021-11,shopping
2021-11-03 00:00:00+00:00,40.64,41675.9,2021-11,transfer
2021-11-03 00:00:00+00:00,-40.0,41715.9,2021-11,transfer
2021-11-03 00:00:00+00:00,-5.0,41720.9,2021-11,groceries / food spend
2021-11-02 00:00:00+00:00,30.0,41690.9,2021-11,transfer
2021-11-02 00:00:00+00:00,-30.0,41720.9,2021-11,transfer
2021-11-02 00:00:00+00:00,10.0,41710.9,2021-11,transfer
2021-11-02 00:00:00+00:00,-0.71,41711.61,2021-11,savings
2021-11-01 00:00:00+00:00,-46.82,41758.43,2021-11,bills and utilities
2021-11-01 00:00:00+00:00,-0.01,41758.44,2021-11,fees and charges
2021-11-01 00:00:00+00:00,-227.0,41985.44,2021-11,transfer
2021-11-01 00:00:00+00:00,-39.99,42025.43,2021-11,groceries / food spend
2021-11-01 00:00:00+00:00,-0.01,42025.44,2021-11,finances
2021-11-01 00:00:00+00:00,-0.01,42025.45,2021-11,shopping
2021-11-01 00:00:00+00:00,-0.01,42025.46,2021-11,shopping
2021-11-01 00:00:00+00:00,-0.02,42025.48,2021-11,groceries / food spend
2021-11-01 00:00:00+00:00,-0.0,42025.48,2021-11,groceries / food spend
2021-11-01 00:00:00+00:00,-0.01,42025.49,2021-11,groceries / food spend
2021-11-01 00:00:00+00:00,-0.02,42025.51,2021-11,groceries / food spend
2021-11-01 00:00:00+00:00,-0.01,42025.52,2021-11,transport
2021-11-01 00:00:00+00:00,-392.88,42418.4,2021-11,restaurants / eating out / delivery
2021-11-01 00:00:00+00:00,-0.0,42418.4,2021-11,home and garden
2021-11-01 00:00:00+00:00,-0.01,42418.41,2021-11,fees and charges
2021-11-01 00:00:00+00:00,-0.01,42418.42,2021-11,transport
2021-11-01 00:00:00+00:00,-0.01,42418.43,2021-11,entertainment
2021-11-01 00:00:00+00:00,-0.01,42418.44,2021-11,fees and charges
2021-11-01 00:00:00+00:00,-16.26,42434.7,2021-11,groceries / food spend
2021-11-01 00:00:00+00:00,-20.91,42455.61,2021-11,transfer
2021-11-01 00:00:00+00:00,-10.07,42465.68,2021-11,business services
2021-11-01 00:00:00+00:00,-10.0,42475.68,2021-11,bills and utilities
2021-11-01 00:00:00+00:00,-10.5,42486.18,2021-11,finances
2021-11-01 00:00:00+00:00,-11.4,42497.58,2021-11,finances
2021-11-01 00:00:00+00:00,-10.39,42507.97,2021-11,bills and utilities
2021-10-28 00:00:00+00:00,101.53,42406.44,2021-10,transfer
2021-10-28 00:00:00+00:00,-36.59,42443.03,2021-10,shopping
2021-10-28 00:00:00+00:00,40.0,42403.03,2021-10,transfer
2021-10-28 00:00:00+00:00,-55.28,42458.31,2021-10,transfer
2021-10-28 00:00:00+00:00,22.42,42435.89,2021-10,taxes
2021-10-27 00:00:00+00:00,-7.93,42443.82,2021-10,transfer
2021-10-27 00:00:00+00:00,38.14,42405.68,2021-10,transfer
2021-10-27 00:00:00+00:00,15.86,42389.82,2021-10,transfer
2021-10-27 00:00:00+00:00,-17.01,42406.83,2021-10,transport
2021-10-27 00:00:00+00:00,-2.65,42409.48,2021-10,finances
2021-10-27 00:00:00+00:00,-23.62,42433.1,2021-10,groceries / food spend
2021-10-27 00:00:00+00:00,-7.56,42440.66,2021-10,shopping
2021-10-25 00:00:00+00:00,46.88,42393.78,2021-10,transfer
2021-10-25 00:00:00+00:00,-36.13,42429.91,2021-10,entertainment
2021-10-25 00:00:00+00:00,-18.51,42448.42,2021-10,transfer
2021-10-25 00:00:00+00:00,-0.41,42448.83,2021-10,savings
2021-10-25 00:00:00+00:00,-12.3,42461.13,2021-10,shopping
2021-10-25 00:00:00+00:00,-0.5,42461.63,2021-10,savings
2021-10-25 00:00:00+00:00,-3.37,42465.0,2021-10,entertainment
2021-10-23 00:00:00+00:00,-30.25,42495.25,2021-10,finances
2021-10-23 00:00:00+00:00,35.93,42459.32,2021-10,transfer
2021-10-23 00:00:00+00:00,-7.3,42466.62,2021-10,transfer
2021-10-23 00:00:00+00:00,-1.56,42468.18,2021-10,savings
2021-10-23 00:00:00+00:00,-22.27,42490.45,2021-10,transfer
2021-10-22 00:00:00+00:00,-1.59,42492.04,2021-10,shopping
2021-10-22 00:00:00+00:00,-0.01,42492.05,2021-10,savings
2021-10-22 00:00:00+00:00,-38.69,42530.74,2021-10,bills and utilities
2021-10-22 00:00:00+00:00,-36.59,42567.33,2021-10,shopping
2021-10-22 00:00:00+00:00,-36.59,42603.92,2021-10,finances
2021-10-20 00:00:00+00:00,-150.0,42753.92,2021-10,rent
2021-10-20 00:00:00+00:00,22.42,42731.5,2021-10,taxes
2021-10-20 00:00:00+00:00,-550.0,43281.5,2021-10,business services
2021-10-20 00:00:00+00:00,350.28,42931.22,2021-10,taxes
2021-10-19 00:00:00+00:00,-7.99,42939.21,2021-10,shopping
2021-10-19 00:00:00+00:00,1450.42,41488.79,2021-10,salary
2021-10-18 00:00:00+00:00,82.21,41406.58,2021-10,finances
2021-10-17 00:00:00+00:00,117.07,41289.51,2021-10,transfer
2021-10-17 00:00:00+00:00,-15.29,41304.8,2021-10,finances
2021-10-17 00:00:00+00:00,-40.0,41344.8,2021-10,finances
2021-10-17 00:00:00+00:00,-20.0,41364.8,2021-10,transport
2021-10-17 00:00:00+00:00,-0.63,41365.43,2021-10,savings
2021-10-17 00:00:00+00:00,-6.37,41371.8,2021-10,groceries / food spend
2021-10-15 00:00:00+00:00,-21.93,41393.73,2021-10,groceries / food spend
2021-10-15 00:00:00+00:00,-0.55,41394.28,2021-10,savings
2021-10-15 00:00:00+00:00,-15.13,41409.41,2021-10,shopping
2021-10-15 00:00:00+00:00,-0.5,41409.91,2021-10,savings
2021-10-15 00:00:00+00:00,-3.59,41413.5,2021-10,shopping
2021-10-15 00:00:00+00:00,-10.0,41423.5,2021-10,shopping
2021-10-14 00:00:00+00:00,-1.03,41424.53,2021-10,entertainment
2021-10-14 00:00:00+00:00,-20.5,41445.03,2021-10,entertainment
2021-10-14 00:00:00+00:00,81.22,41363.81,2021-10,entertainment
2021-10-12 00:00:00+00:00,-0.41,41364.22,2021-10,savings
2021-10-12 00:00:00+00:00,-23.11,41387.33,2021-10,transport
2021-10-11 00:00:00+00:00,43.38,41343.95,2021-10,finances
2021-10-11 00:00:00+00:00,50.0,41293.95,2021-10,transfer
2021-10-11 00:00:00+00:00,24.31,41269.64,2021-10,taxes
2021-10-11 00:00:00+00:00,-17.0,41286.64,2021-10,holidays
2021-10-10 00:00:00+00:00,-37.89,41324.53,2021-10,finances
2021-10-10 00:00:00+00:00,-7.66,41332.19,2021-10,groceries / food spend
2021-10-10 00:00:00+00:00,33.23,41298.96,2021-10,transfer
2021-10-10 00:00:00+00:00,50.36,41248.6,2021-10,finances
2021-10-10 00:00:00+00:00,-54.47,41303.07,2021-10,transfer
2021-10-10 00:00:00+00:00,-23.91,41326.98,2021-10,bills and utilities
2021-10-09 00:00:00+00:00,-25.08,41352.06,2021-10,transport
2021-10-09 00:00:00+00:00,-20.56,41372.62,2021-10,taxes
2021-10-09 00:00:00+00:00,-0.41,41373.03,2021-10,savings
2021-10-09 00:00:00+00:00,70.0,41303.03,2021-10,transfer
2021-10-08 00:00:00+00:00,-0.01,41303.04,2021-10,savings
2021-10-08 00:00:00+00:00,22.42,41280.62,2021-10,taxes
2021-10-08 00:00:00+00:00,-24.55,41305.17,2021-10,fees and charges
2021-10-08 00:00:00+00:00,-100.0,41405.17,2021-10,rent
2021-10-08 00:00:00+00:00,-10.31,41415.48,2021-10,entertainment
2021-10-08 00:00:00+00:00,-0.6,41416.08,2021-10,savings
2021-10-08 00:00:00+00:00,-1.01,41417.09,2021-10,savings
2021-10-08 00:00:00+00:00,-24.31,41441.4,2021-10,groceries / food spend
2021-10-07 00:00:00+00:00,-81.13,41522.53,2021-10,bills and utilities
2021-10-07 00:00:00+00:00,-1.22,41523.75,2021-10,savings
2021-10-07 00:00:00+00:00,-70.0,41593.75,2021-10,transfer
2021-10-06 00:00:00+00:00,-28.48,41622.23,2021-10,bills and utilities
2021-10-06 00:00:00+00:00,22.42,41599.81,2021-10,taxes
2021-10-06 00:00:00+00:00,-6.64,41606.45,2021-10,groceries / food spend
2021-10-06 00:00:00+00:00,-50.0,41656.45,2021-10,bills and utilities
2021-10-06 00:00:00+00:00,-14.32,41670.77,2021-10,home and garden
2021-10-06 00:00:00+00:00,346.35,41324.42,2021-10,taxes
2021-10-06 00:00:00+00:00,235.38,41089.04,2021-10,transfer
2021-10-06 00:00:00+00:00,61.89,41027.15,2021-10,transfer
2021-10-06 00:00:00+00:00,-0.01,41027.16,2021-10,savings
2021-10-06 00:00:00+00:00,-5.2,41032.36,2021-10,shopping
2021-10-05 00:00:00+00:00,-38.32,41070.68,2021-10,transfer
2021-10-05 00:00:00+00:00,-1.89,41072.57,2021-10,savings
2021-10-05 00:00:00+00:00,-4.47,41077.04,2021-10,finances
2021-10-05 00:00:00+00:00,-7.99,41085.03,2021-10,shopping
2021-10-05 00:00:00+00:00,-18.95,41103.98,2021-10,transfer
2021-10-05 00:00:00+00:00,-14.26,41118.24,2021-10,finances
2021-10-05 00:00:00+00:00,-8.39,41126.63,2021-10,groceries / food spend
2021-10-05 00:00:00+00:00,-26.85,41153.48,2021-10,shopping
2021-10-04 00:00:00+00:00,8.52,41144.96,2021-10,transfer
2021-10-04 00:00:00+00:00,70.0,41074.96,2021-10,transfer
2021-10-04 00:00:00+00:00,85.07,40989.89,2021-10,transfer
2021-10-04 00:00:00+00:00,-20.0,41009.89,2021-10,transfer
2021-10-04 00:00:00+00:00,-7.49,41017.38,2021-10,shopping
2021-10-04 00:00:00+00:00,-2.53,41019.91,2021-10,finances
2021-10-04 00:00:00+00:00,-100.0,41119.91,2021-10,transfer
2021-10-04 00:00:00+00:00,100.0,41019.91,2021-10,transfer
2021-10-04 00:00:00+00:00,-4.22,41024.13,2021-10,business services
2021-10-04 00:00:00+00:00,25.0,40999.13,2021-10,transfer
2021-10-04 00:00:00+00:00,-130.0,41129.13,2021-10,rent
2021-10-03 00:00:00+00:00,0.77,41128.36,2021-10,transfer
2021-10-03 00:00:00+00:00,-0.43,41128.79,2021-10,savings
2021-10-03 00:00:00+00:00,130.0,40998.79,2021-10,transfer
2021-10-03 00:00:00+00:00,7.0,40991.79,2021-10,transfer
2021-10-03 00:00:00+00:00,-23.11,41014.9,2021-10,transport
2021-10-03 00:00:00+00:00,41.57,40973.33,2021-10,entertainment
2021-10-03 00:00:00+00:00,-0.01,40973.34,2021-10,savings
2021-10-03 00:00:00+00:00,-2.45,40975.79,2021-10,entertainment
2021-10-03 00:00:00+00:00,-30.0,41005.79,2021-10,shopping
2021-10-03 00:00:00+00:00,40.0,40965.79,2021-10,transfer
2021-10-03 00:00:00+00:00,-40.0,41005.79,2021-10,transfer
2021-10-03 00:00:00+00:00,-5.0,41010.79,2021-10,groceries / food spend
2021-10-02 00:00:00+00:00,30.0,40980.79,2021-10,transfer
2021-10-02 00:00:00+00:00,-41.62,41022.41,2021-10,transfer
2021-10-02 00:00:00+00:00,2.85,41019.56,2021-10,transfer
2021-10-02 00:00:00+00:00,-0.65,41020.21,2021-10,savings
2021-10-01 00:00:00+00:00,-46.82,41067.03,2021-10,bills and utilities
2021-10-01 00:00:00+00:00,-0.01,41067.04,2021-10,fees and charges
2021-10-01 00:00:00+00:00,-613.59,41680.63,2021-10,transfer
2021-10-01 00:00:00+00:00,-59.44,41740.07,2021-10,groceries / food spend
2021-10-01 00:00:00+00:00,-0.01,41740.08,2021-10,finances
2021-10-01 00:00:00+00:00,-0.02,41740.1,2021-10,shopping
2021-10-01 00:00:00+00:00,-0.01,41740.11,2021-10,shopping
2021-10-01 00:00:00+00:00,-0.01,41740.12,2021-10,groceries / food spend
2021-10-01 00:00:00+00:00,-0.01,41740.13,2021-10,groceries / food spend
2021-10-01 00:00:00+00:00,-0.01,41740.14,2021-10,groceries / food spend
2021-10-01 00:00:00+00:00,-0.01,41740.15,2021-10,groceries / food spend
2021-10-01 00:00:00+00:00,-0.01,41740.16,2021-10,transport
2021-10-01 00:00:00+00:00,-179.52,41919.68,2021-10,restaurants / eating out / delivery
2021-10-01 00:00:00+00:00,0.0,41919.68,2021-10,home and garden
2021-10-01 00:00:00+00:00,-0.01,41919.69,2021-10,fees and charges
2021-10-01 00:00:00+00:00,-0.01,41919.7,2021-10,transport
2021-10-01 00:00:00+00:00,-0.01,41919.71,2021-10,entertainment
2021-10-01 00:00:00+00:00,-0.01,41919.72,2021-10,fees and charges
2021-10-01 00:00:00+00:00,-13.68,41933.4,2021-10,groceries / food spend
2021-10-01 00:00:00+00:00,-26.91,41960.31,2021-10,transfer
2021-10-01 00:00:00+00:00,-10.0,41970.31,2021-10,business services
2021-10-01 00:00:00+00:00,-8.53,41978.84,2021-10,bills and utilities
2021-10-01 00:00:00+00:00,-10.0,41988.84,2021-10,finances
2021-10-01 00:00:00+00:00,-10.0,41998.84,2021-10,finances
2021-10-01 00:00:00+00:00,-8.59,42007.43,2021-10,bills and utilities
2021-09-28 00:00:00+00:00,486.9,41520.53,2021-09,transfer
2021-09-28 00:00:00+00:00,-51.49,41572.02,2021-09,shopping
2021-09-28 00:00:00+00:00,23.23,41548.79,2021-09,transfer
2021-09-28 00:00:00+00:00,-32.72,41581.51,2021-09,transfer
2021-09-28 00:00:00+00:00,22.42,41559.09,2021-09,taxes
2021-09-27 00:00:00+00:00,-2.01,41561.1,2021-09,transfer
2021-09-27 00:00:00+00:00,69.77,41491.33,2021-09,transfer
2021-09-27 00:00:00+00:00,20.05,41471.28,2021-09,transfer
2021-09-27 00:00:00+00:00,-20.56,41491.84,2021-09,transport
2021-09-27 00:00:00+00:00,-1.9,41493.74,2021-09,finances
2021-09-27 00:00:00+00:00,-23.62,41517.36,2021-09,groceries / food spend
2021-09-27 00:00:00+00:00,-1.06,41518.42,2021-09,shopping
2021-09-25 00:00:00+00:00,88.69,41429.73,2021-09,transfer
2021-09-25 00:00:00+00:00,-24.5,41454.23,2021-09,entertainment
2021-09-25 00:00:00+00:00,-10.0,41464.23,2021-09,transfer
2021-09-25 00:00:00+00:00,-0.38,41464.61,2021-09,savings
2021-09-25 00:00:00+00:00,-84.78,41549.39,2021-09,shopping
2021-09-25 00:00:00+00:00,-0.5,41549.89,2021-09,savings
2021-09-25 00:00:00+00:00,-8.7,41558.59,2021-09,entertainment
2021-09-23 00:00:00+00:00,-30.0,41588.59,2021-09,finances
2021-09-23 00:00:00+00:00,38.47,41550.12,2021-09,transfer
2021-09-23 00:00:00+00:00,-100.0,41650.12,2021-09,transfer
2021-09-23 00:00:00+00:00,-1.49,41651.61,2021-09,savings
2021-09-23 00:00:00+00:00,-8.47,41660.08,2021-09,transfer
2021-09-22 00:00:00+00:00,-7.32,41667.4,2021-09,shopping
2021-09-22 00:00:00+00:00,-0.01,41667.41,2021-09,savings
2021-09-22 00:00:00+00:00,-39.25,41706.66,2021-09,bills and utilities
2021-09-22 00:00:00+00:00,-36.59,41743.25,2021-09,shopping
2021-09-22 00:00:00+00:00,-29.47,41772.72,2021-09,finances
2021-09-20 00:00:00+00:00,-150.0,41922.72,2021-09,rent
2021-09-20 00:00:00+00:00,22.42,41900.3,2021-09,taxes
2021-09-20 00:00:00+00:00,-550.0,42450.3,2021-09,business services
2021-09-20 00:00:00+00:00,329.39,42120.91,2021-09,taxes
2021-09-19 00:00:00+00:00,-7.99,42128.9,2021-09,shopping
2021-09-19 00:00:00+00:00,1450.42,40678.48,2021-09,salary
2021-09-18 00:00:00+00:00,113.21,40565.27,2021-09,finances
2021-09-17 00:00:00+00:00,137.6,40427.67,2021-09,transfer
2021-09-17 00:00:00+00:00,-17.03,40444.7,2021-09,finances
2021-09-17 00:00:00+00:00,-39.97,40484.67,2021-09,finances
2021-09-17 00:00:00+00:00,-20.0,40504.67,2021-09,transport
2021-09-17 00:00:00+00:00,-0.63,40505.3,2021-09,savings
2021-09-17 00:00:00+00:00,-6.37,40511.67,2021-09,groceries / food spend
2021-09-15 00:00:00+00:00,-5.8,40517.47,2021-09,groceries / food spend
2021-09-15 00:00:00+00:00,-0.48,40517.95,2021-09,savings
2021-09-15 00:00:00+00:00,-1.98,40519.93,2021-09,shopping
2021-09-15 00:00:00+00:00,-0.5,40520.43,2021-09,savings
2021-09-15 00:00:00+00:00,-3.59,40524.02,2021-09,shopping
2021-09-15 00:00:00+00:00,-10.0,40534.02,2021-09,shopping
2021-09-14 00:00:00+00:00,-2.0,40536.02,2021-09,entertainment
2021-09-14 00:00:00+00:00,-24.21,40560.23,2021-09,entertainment
2021-09-14 00:00:00+00:00,52.53,40507.7,2021-09,entertainment
2021-09-12 00:00:00+00:00,-0.4,40508.1,2021-09,savings
2021-09-12 00:00:00+00:00,-23.11,40531.21,2021-09,transport
2021-09-11 00:00:00+00:00,50.0,40481.21,2021-09,finances
2021-09-11 00:00:00+00:00,50.0,40431.21,2021-09,transfer
2021-09-11 00:00:00+00:00,23.31,40407.9,2021-09,taxes
2021-09-11 00:00:00+00:00,-10.67,40418.57,2021-09,holidays
2021-09-10 00:00:00+00:00,-40.0,40458.57,2021-09,finances
2021-09-10 00:00:00+00:00,-5.0,40463.57,2021-09,groceries / food spend
2021-09-10 00:00:00+00:00,40.0,40423.57,2021-09,transfer
2021-09-10 00:00:00+00:00,39.42,40384.15,2021-09,finances
2021-09-10 00:00:00+00:00,-30.0,40414.15,2021-09,transfer
2021-09-10 00:00:00+00:00,-24.5,40438.65,2021-09,bills and utilities
2021-09-09 00:00:00+00:00,-23.62,40462.27,2021-09,transport
2021-09-09 00:00:00+00:00,-22.07,40484.34,2021-09,taxes
2021-09-09 00:00:00+00:00,-0.38,40484.72,2021-09,savings
2021-09-09 00:00:00+00:00,70.0,40414.72,2021-09,transfer
2021-09-08 00:00:00+00:00,-0.01,40414.73,2021-09,savings
2021-09-08 00:00:00+00:00,21.34,40393.39,2021-09,taxes
2021-09-08 00:00:00+00:00,-14.99,40408.38,2021-09,fees and charges
2021-09-08 00:00:00+00:00,-100.0,40508.38,2021-09,rent
2021-09-08 00:00:00+00:00,-10.0,40518.38,2021-09,entertainment
2021-09-08 00:00:00+00:00,-0.71,40519.09,2021-09,savings
2021-09-08 00:00:00+00:00,-1.04,40520.13,2021-09,savings
2021-09-08 00:00:00+00:00,-11.08,40531.21,2021-09,groceries / food spend
2021-09-07 00:00:00+00:00,-80.2,40611.41,2021-09,bills and utilities
2021-09-07 00:00:00+00:00,-1.15,40612.56,2021-09,savings
2021-09-07 00:00:00+00:00,-70.0,40682.56,2021-09,transfer
2021-09-06 00:00:00+00:00,-31.18,40713.74,2021-09,bills and utilities
2021-09-06 00:00:00+00:00,22.42,40691.32,2021-09,taxes
2021-09-06 00:00:00+00:00,-9.17,40700.49,2021-09,groceries / food spend
2021-09-06 00:00:00+00:00,-50.0,40750.49,2021-09,bills and utilities
2021-09-06 00:00:00+00:00,-1.58,40752.07,2021-09,home and garden
2021-09-06 00:00:00+00:00,347.33,40404.74,2021-09,taxes
2021-09-06 00:00:00+00:00,137.6,40267.14,2021-09,transfer
2021-09-06 00:00:00+00:00,48.56,40218.58,2021-09,transfer
2021-09-06 00:00:00+00:00,-0.01,40218.59,2021-09,savings
2021-09-06 00:00:00+00:00,-5.0,40223.59,2021-09,shopping
2021-09-05 00:00:00+00:00,-98.53,40322.12,2021-09,transfer
2021-09-05 00:00:00+00:00,-1.89,40324.01,2021-09,savings
2021-09-05 00:00:00+00:00,-5.79,40329.8,2021-09,finances
2021-09-05 00:00:00+00:00,-9.93,40339.73,2021-09,shopping
2021-09-05 00:00:00+00:00,-16.93,40356.66,2021-09,transfer
2021-09-05 00:00:00+00:00,-12.47,40369.13,2021-09,finances
2021-09-05 00:00:00+00:00,-6.37,40375.5,2021-09,groceries / food spend
2021-09-05 00:00:00+00:00,-20.0,40395.5,2021-09,shopping
2021-09-04 00:00:00+00:00,8.97,40386.53,2021-09,transfer
2021-09-04 00:00:00+00:00,70.0,40316.53,2021-09,transfer
2021-09-04 00:00:00+00:00,59.17,40257.36,2021-09,transfer
2021-09-04 00:00:00+00:00,-8.68,40266.04,2021-09,transfer
2021-09-04 00:00:00+00:00,-1.06,40267.1,2021-09,shopping
2021-09-04 00:00:00+00:00,-3.07,40270.17,2021-09,finances
2021-09-04 00:00:00+00:00,-100.0,40370.17,2021-09,transfer
2021-09-04 00:00:00+00:00,100.0,40270.17,2021-09,transfer
2021-09-04 00:00:00+00:00,-3.07,40273.24,2021-09,business services
2021-09-04 00:00:00+00:00,39.33,40233.91,2021-09,transfer
2021-09-04 00:00:00+00:00,-130.0,40363.91,2021-09,rent
2021-09-03 00:00:00+00:00,2.09,40361.82,2021-09,transfer
2021-09-03 00:00:00+00:00,-0.35,40362.17,2021-09,savings
2021-09-03 00:00:00+00:00,202.23,40159.94,2021-09,transfer
2021-09-03 00:00:00+00:00,3.41,40156.53,2021-09,transfer
2021-09-03 00:00:00+00:00,-23.11,40179.64,2021-09,transport
2021-09-03 00:00:00+00:00,27.39,40152.25,2021-09,entertainment
2021-09-03 00:00:00+00:00,-0.01,40152.26,2021-09,savings
2021-09-03 00:00:00+00:00,-2.99,40155.25,2021-09,entertainment
2021-09-03 00:00:00+00:00,-30.0,40185.25,2021-09,shopping
2021-09-03 00:00:00+00:00,49.4,40135.85,2021-09,transfer
2021-09-03 00:00:00+00:00,-40.0,40175.85,2021-09,transfer
2021-09-03 00:00:00+00:00,-5.0,40180.85,2021-09,groceries / food spend
2021-09-02 00:00:00+00:00,46.03,40134.82,2021-09,transfer
2021-09-02 00:00:00+00:00,-41.77,40176.59,2021-09,transfer
2021-09-02 00:00:00+00:00,9.24,40167.35,2021-09,transfer
2021-09-02 00:00:00+00:00,-0.61,40167.96,2021-09,savings
2021-09-01 00:00:00+00:00,-46.82,40214.78,2021-09,bills and utilities
2021-09-01 00:00:00+00:00,-0.01,40214.79,2021-09,fees and charges
2021-09-01 00:00:00+00:00,-124.97,40339.76,2021-09,transfer
2021-09-01 00:00:00+00:00,-67.43,40407.19,2021-09,groceries / food spend
2021-09-01 00:00:00+00:00,-0.01,40407.2,2021-09,finances
2021-09-01 00:00:00+00:00,-0.01,40407.21,2021-09,shopping
2021-09-01 00:00:00+00:00,-0.0,40407.21,2021-09,shopping
2021-09-01 00:00:00+00:00,-0.01,40407.22,2021-09,groceries / food spend
2021-09-01 00:00:00+00:00,-0.0,40407.22,2021-09,groceries / food spend
2021-09-01 00:00:00+00:00,-0.01,40407.23,2021-09,groceries / food spend
2021-09-01 00:00:00+00:00,-0.01,40407.24,2021-09,groceries / food spend
2021-09-01 00:00:00+00:00,-0.01,40407.25,2021-09,transport
2021-09-01 00:00:00+00:00,-111.55,40518.8,2021-09,restaurants / eating out / delivery
2021-09-01 00:00:00+00:00,-0.01,40518.81,2021-09,home and garden
2021-09-01 00:00:00+00:00,-0.01,40518.82,2021-09,fees and charges
2021-09-01 00:00:00+00:00,-0.01,40518.83,2021-09,transport
2021-09-01 00:00:00+00:00,-0.01,40518.84,2021-09,entertainment
2021-09-01 00:00:00+00:00,-0.01,40518.85,2021-09,fees and charges
2021-09-01 00:00:00+00:00,-33.82,40552.67,2021-09,groceries / food spend
2021-09-01 00:00:00+00:00,-6.85,40559.52,2021-09,transfer
2021-09-01 00:00:00+00:00,-10.0,40569.52,2021-09,business services
2021-09-01 00:00:00+00:00,-8.65,40578.17,2021-09,bills and utilities
2021-09-01 00:00:00+00:00,-9.7,40587.87,2021-09,finances
2021-09-01 00:00:00+00:00,-8.62,40596.49,2021-09,finances
2021-09-01 00:00:00+00:00,-9.53,40606.02,2021-09,bills and utilities
2021-08-28 00:00:00+00:00,560.86,40045.16,2021-08,transfer
2021-08-28 00:00:00+00:00,-83.81,40128.97,2021-08,shopping
2021-08-28 00:00:00+00:00,40.0,40088.97,2021-08,transfer
2021-08-28 00:00:00+00:00,-33.1,40122.07,2021-08,transfer
2021-08-28 00:00:00+00:00,22.42,40099.65,2021-08,taxes
2021-08-27 00:00:00+00:00,-7.93,40107.58,2021-08,transfer
2021-08-27 00:00:00+00:00,88.09,40019.49,2021-08,transfer
2021-08-27 00:00:00+00:00,16.0,40003.49,2021-08,transfer
2021-08-27 00:00:00+00:00,-13.83,40017.32,2021-08,transport
2021-08-27 00:00:00+00:00,-3.91,40021.23,2021-08,finances
2021-08-27 00:00:00+00:00,-55.55,40076.78,2021-08,groceries / food spend
2021-08-27 00:00:00+00:00,-11.27,40088.05,2021-08,shopping
2021-08-25 00:00:00+00:00,32.78,40055.27,2021-08,transfer
2021-08-25 00:00:00+00:00,-24.5,40079.77,2021-08,entertainment
2021-08-25 00:00:00+00:00,-10.0,40089.77,2021-08,transfer
2021-08-25 00:00:00+00:00,-0.42,40090.19,2021-08,savings
2021-08-25 00:00:00+00:00,-25.64,40115.83,2021-08,shopping
2021-08-25 00:00:00+00:00,-0.53,40116.36,2021-08,savings
2021-08-25 00:00:00+00:00,-10.5,40126.86,2021-08,entertainment
2021-08-23 00:00:00+00:00,-31.18,40158.04,2021-08,finances
2021-08-23 00:00:00+00:00,11.62,40146.42,2021-08,transfer
2021-08-23 00:00:00+00:00,-95.93,40242.35,2021-08,transfer
2021-08-23 00:00:00+00:00,-1.57,40243.92,2021-08,savings
2021-08-23 00:00:00+00:00,-20.0,40263.92,2021-08,transfer
2021-08-22 00:00:00+00:00,-5.0,40268.92,2021-08,shopping
2021-08-22 00:00:00+00:00,-0.01,40268.93,2021-08,savings
2021-08-22 00:00:00+00:00,-39.25,40308.18,2021-08,bills and utilities
2021-08-22 00:00:00+00:00,-51.81,40359.99,2021-08,shopping
2021-08-22 00:00:00+00:00,-36.59,40396.58,2021-08,finances
2021-08-20 00:00:00+00:00,-150.0,40546.58,2021-08,rent
2021-08-20 00:00:00+00:00,19.9,40526.68,2021-08,taxes
2021-08-20 00:00:00+00:00,-184.12,40710.8,2021-08,business services
2021-08-20 00:00:00+00:00,304.34,40406.46,2021-08,taxes
2021-08-19 00:00:00+00:00,-7.99,40414.45,2021-08,shopping
2021-08-19 00:00:00+00:00,1450.42,38964.03,2021-08,salary
2021-08-18 00:00:00+00:00,82.21,38881.82,2021-08,finances
2021-08-17 00:00:00+00:00,137.6,38744.22,2021-08,transfer
2021-08-17 00:00:00+00:00,-12.73,38756.95,2021-08,finances
2021-08-17 00:00:00+00:00,-40.0,38796.95,2021-08,finances
2021-08-17 00:00:00+00:00,-20.0,38816.95,2021-08,transport
2021-08-17 00:00:00+00:00,-0.63,38817.58,2021-08,savings
2021-08-17 00:00:00+00:00,-6.37,38823.95,2021-08,groceries / food spend
2021-08-15 00:00:00+00:00,-32.0,38855.95,2021-08,groceries / food spend
2021-08-15 00:00:00+00:00,-0.55,38856.5,2021-08,savings
2021-08-15 00:00:00+00:00,-15.45,38871.95,2021-08,shopping
2021-08-15 00:00:00+00:00,-0.5,38872.45,2021-08,savings
2021-08-15 00:00:00+00:00,-2.64,38875.09,2021-08,shopping
2021-08-15 00:00:00+00:00,-10.0,38885.09,2021-08,shopping
2021-08-14 00:00:00+00:00,-2.55,38887.64,2021-08,entertainment
2021-08-14 00:00:00+00:00,-22.59,38910.23,2021-08,entertainment
2021-08-14 00:00:00+00:00,118.57,38791.66,2021-08,entertainment
2021-08-12 00:00:00+00:00,-0.41,38792.07,2021-08,savings
2021-08-12 00:00:00+00:00,-25.49,38817.56,2021-08,transport
2021-08-11 00:00:00+00:00,54.64,38762.92,2021-08,finances
2021-08-11 00:00:00+00:00,50.0,38712.92,2021-08,transfer
2021-08-11 00:00:00+00:00,22.42,38690.5,2021-08,taxes
2021-08-11 00:00:00+00:00,-4.53,38695.03,2021-08,holidays
2021-08-10 00:00:00+00:00,-40.0,38735.03,2021-08,finances
2021-08-10 00:00:00+00:00,-5.0,38740.03,2021-08,groceries / food spend
2021-08-10 00:00:00+00:00,40.0,38700.03,2021-08,transfer
2021-08-10 00:00:00+00:00,51.21,38648.82,2021-08,finances
2021-08-10 00:00:00+00:00,-15.0,38663.82,2021-08,transfer
2021-08-10 00:00:00+00:00,-24.5,38688.32,2021-08,bills and utilities
2021-08-09 00:00:00+00:00,-20.38,38708.7,2021-08,transport
2021-08-09 00:00:00+00:00,-20.56,38729.26,2021-08,taxes
2021-08-09 00:00:00+00:00,-0.41,38729.67,2021-08,savings
2021-08-09 00:00:00+00:00,53.01,38676.66,2021-08,transfer
2021-08-08 00:00:00+00:00,-0.01,38676.67,2021-08,savings
2021-08-08 00:00:00+00:00,22.42,38654.25,2021-08,taxes
2021-08-08 00:00:00+00:00,-29.04,38683.29,2021-08,fees and charges
2021-08-08 00:00:00+00:00,-100.0,38783.29,2021-08,rent
2021-08-08 00:00:00+00:00,-10.0,38793.29,2021-08,entertainment
2021-08-08 00:00:00+00:00,-0.63,38793.92,2021-08,savings
2021-08-08 00:00:00+00:00,-1.04,38794.96,2021-08,savings
2021-08-08 00:00:00+00:00,-24.31,38819.27,2021-08,groceries / food spend
2021-08-07 00:00:00+00:00,-82.37,38901.64,2021-08,bills and utilities
2021-08-07 00:00:00+00:00,-1.02,38902.66,2021-08,savings
2021-08-07 00:00:00+00:00,-70.0,38972.66,2021-08,transfer
2021-08-06 00:00:00+00:00,-27.73,39000.39,2021-08,bills and utilities
2021-08-06 00:00:00+00:00,22.42,38977.97,2021-08,taxes
2021-08-06 00:00:00+00:00,-12.89,38990.86,2021-08,groceries / food spend
2021-08-06 00:00:00+00:00,-48.41,39039.27,2021-08,bills and utilities
2021-08-06 00:00:00+00:00,-18.34,39057.61,2021-08,home and garden
2021-08-06 00:00:00+00:00,346.35,38711.26,2021-08,taxes
2021-08-06 00:00:00+00:00,137.6,38573.66,2021-08,transfer
2021-08-06 00:00:00+00:00,68.69,38504.97,2021-08,transfer
2021-08-06 00:00:00+00:00,-0.01,38504.98,2021-08,savings
2021-08-06 00:00:00+00:00,-5.0,38509.98,2021-08,shopping
2021-08-05 00:00:00+00:00,-60.0,38569.98,2021-08,transfer
2021-08-05 00:00:00+00:00,-1.89,38571.87,2021-08,savings
2021-08-05 00:00:00+00:00,-5.79,38577.66,2021-08,finances
2021-08-05 00:00:00+00:00,-17.35,38595.01,2021-08,shopping
2021-08-05 00:00:00+00:00,-7.74,38602.75,2021-08,transfer
2021-08-05 00:00:00+00:00,-10.05,38612.8,2021-08,finances
2021-08-05 00:00:00+00:00,-6.37,38619.17,2021-08,groceries / food spend
2021-08-05 00:00:00+00:00,-20.0,38639.17,2021-08,shopping
2021-08-04 00:00:00+00:00,10.0,38629.17,2021-08,transfer
2021-08-04 00:00:00+00:00,78.0,38551.17,2021-08,transfer
2021-08-04 00:00:00+00:00,59.17,38492.0,2021-08,transfer
2021-08-04 00:00:00+00:00,-20.0,38512.0,2021-08,transfer
2021-08-04 00:00:00+00:00,1.61,38510.39,2021-08,shopping
2021-08-04 00:00:00+00:00,-2.45,38512.84,2021-08,finances
2021-08-04 00:00:00+00:00,-132.77,38645.61,2021-08,transfer
2021-08-04 00:00:00+00:00,141.3,38504.31,2021-08,transfer
2021-08-04 00:00:00+00:00,-2.4,38506.71,2021-08,business services
2021-08-04 00:00:00+00:00,4.69,38502.02,2021-08,transfer
2021-08-04 00:00:00+00:00,-130.0,38632.02,2021-08,rent
2021-08-03 00:00:00+00:00,0.89,38631.13,2021-08,transfer
2021-08-03 00:00:00+00:00,-0.41,38631.54,2021-08,savings
2021-08-03 00:00:00+00:00,132.15,38499.39,2021-08,transfer
2021-08-03 00:00:00+00:00,6.99,38492.4,2021-08,transfer
2021-08-03 00:00:00+00:00,-23.11,38515.51,2021-08,transport
2021-08-03 00:00:00+00:00,47.13,38468.38,2021-08,entertainment
2021-08-03 00:00:00+00:00,-0.01,38468.39,2021-08,savings
2021-08-03 00:00:00+00:00,-2.55,38470.94,2021-08,entertainment
2021-08-03 00:00:00+00:00,-30.0,38500.94,2021-08,shopping
2021-08-03 00:00:00+00:00,40.0,38460.94,2021-08,transfer
2021-08-03 00:00:00+00:00,-40.0,38500.94,2021-08,transfer
2021-08-03 00:00:00+00:00,-5.0,38505.94,2021-08,groceries / food spend
2021-08-02 00:00:00+00:00,30.0,38475.94,2021-08,transfer
2021-08-02 00:00:00+00:00,-33.15,38509.09,2021-08,transfer
2021-08-02 00:00:00+00:00,10.0,38499.09,2021-08,transfer
2021-08-02 00:00:00+00:00,-0.63,38499.72,2021-08,savings
2021-08-01 00:00:00+00:00,-46.82,38546.54,2021-08,bills and utilities
2021-08-01 00:00:00+00:00,-0.02,38546.56,2021-08,fees and charges
2021-08-01 00:00:00+00:00,-261.62,38808.18,2021-08,transfer
2021-08-01 00:00:00+00:00,-19.75,38827.93,2021-08,groceries / food spend
2021-08-01 00:00:00+00:00,-0.01,38827.94,2021-08,finances
2021-08-01 00:00:00+00:00,-0.01,38827.95,2021-08,shopping
2021-08-01 00:00:00+00:00,-0.01,38827.96,2021-08,shopping
2021-08-01 00:00:00+00:00,-0.01,38827.97,2021-08,groceries / food spend
2021-08-01 00:00:00+00:00,-0.01,38827.98,2021-08,groceries / food spend
2021-08-01 00:00:00+00:00,-0.01,38827.99,2021-08,groceries / food spend
2021-08-01 00:00:00+00:00,-0.01,38828.0,2021-08,groceries / food spend
2021-08-01 00:00:00+00:00,-0.01,38828.01,2021-08,transport
2021-08-01 00:00:00+00:00,-242.22,39070.23,2021-08,restaurants / eating out / delivery
2021-08-01 00:00:00+00:00,-0.01,39070.24,2021-08,home and garden
2021-08-01 00:00:00+00:00,-0.01,39070.25,2021-08,fees and charges
2021-08-01 00:00:00+00:00,-0.01,39070.26,2021-08,transport
2021-08-01 00:00:00+00:00,-0.01,39070.27,2021-08,entertainment
2021-08-01 00:00:00+00:00,-0.0,39070.27,2021-08,fees and charges
2021-08-01 00:00:00+00:00,-17.12,39087.39,2021-08,groceries / food spend
2021-08-01 00:00:00+00:00,-10.65,39098.04,2021-08,transfer
2021-08-01 00:00:00+00:00,-12.54,39110.58,2021-08,business services
2021-08-01 00:00:00+00:00,-9.31,39119.89,2021-08,bills and utilities
2021-08-01 00:00:00+00:00,-9.39,39129.28,2021-08,finances
2021-08-01 00:00:00+00:00,-10.0,39139.28,2021-08,finances
2021-08-01 00:00:00+00:00,-10.0,39149.28,2021-08,bills and utilities
2021-07-28 00:00:00+00:00,420.0,38729.28,2021-07,transfer
2021-07-28 00:00:00+00:00,11.61,38717.67,2021-07,shopping
2021-07-28 00:00:00+00:00,40.0,38677.67,2021-07,transfer
2021-07-28 00:00:00+00:00,-47.31,38724.98,2021-07,transfer
2021-07-28 00:00:00+00:00,22.42,38702.56,2021-07,taxes
2021-07-27 00:00:00+00:00,-4.08,38706.64,2021-07,transfer
2021-07-27 00:00:00+00:00,50.59,38656.05,2021-07,transfer
2021-07-27 00:00:00+00:00,15.86,38640.19,2021-07,transfer
2021-07-27 00:00:00+00:00,-15.1,38655.29,2021-07,transport
2021-07-27 00:00:00+00:00,-3.03,38658.32,2021-07,finances
2021-07-27 00:00:00+00:00,-23.62,38681.94,2021-07,groceries / food spend
2021-07-27 00:00:00+00:00,-7.56,38689.5,2021-07,shopping
2021-07-25 00:00:00+00:00,44.61,38644.89,2021-07,transfer
2021-07-25 00:00:00+00:00,-29.45,38674.34,2021-07,entertainment
2021-07-25 00:00:00+00:00,-10.0,38684.34,2021-07,transfer
2021-07-25 00:00:00+00:00,-0.49,38684.83,2021-07,savings
2021-07-25 00:00:00+00:00,-33.38,38718.21,2021-07,shopping
2021-07-25 00:00:00+00:00,-0.5,38718.71,2021-07,savings
2021-07-25 00:00:00+00:00,-10.5,38729.21,2021-07,entertainment
2021-07-23 00:00:00+00:00,-30.0,38759.21,2021-07,finances
2021-07-23 00:00:00+00:00,32.5,38726.71,2021-07,transfer
2021-07-23 00:00:00+00:00,-61.48,38788.19,2021-07,transfer
2021-07-23 00:00:00+00:00,-1.57,38789.76,2021-07,savings
2021-07-23 00:00:00+00:00,-20.0,38809.76,2021-07,transfer
2021-07-22 00:00:00+00:00,-5.0,38814.76,2021-07,shopping
2021-07-22 00:00:00+00:00,-0.01,38814.77,2021-07,savings
2021-07-22 00:00:00+00:00,-41.48,38856.25,2021-07,bills and utilities
2021-07-22 00:00:00+00:00,-13.64,38869.89,2021-07,shopping
2021-07-22 00:00:00+00:00,-45.93,38915.82,2021-07,finances
2021-07-20 00:00:00+00:00,-150.0,39065.82,2021-07,rent
2021-07-20 00:00:00+00:00,22.42,39043.4,2021-07,taxes
2021-07-20 00:00:00+00:00,-550.0,39593.4,2021-07,business services
2021-07-20 00:00:00+00:00,335.26,39258.14,2021-07,taxes
2021-07-19 00:00:00+00:00,-7.99,39266.13,2021-07,shopping
2021-07-19 00:00:00+00:00,1450.42,37815.71,2021-07,salary
2021-07-18 00:00:00+00:00,82.21,37733.5,2021-07,finances
2021-07-17 00:00:00+00:00,133.1,37600.4,2021-07,transfer
2021-07-17 00:00:00+00:00,-12.73,37613.13,2021-07,finances
2021-07-17 00:00:00+00:00,-40.0,37653.13,2021-07,finances
2021-07-17 00:00:00+00:00,-28.47,37681.6,2021-07,transport
2021-07-17 00:00:00+00:00,-0.63,37682.23,2021-07,savings
2021-07-17 00:00:00+00:00,-6.22,37688.45,2021-07,groceries / food spend
2021-07-15 00:00:00+00:00,-32.0,37720.45,2021-07,groceries / food spend
2021-07-15 00:00:00+00:00,-0.55,37721.0,2021-07,savings
2021-07-15 00:00:00+00:00,-15.45,37736.45,2021-07,shopping
2021-07-15 00:00:00+00:00,-0.5,37736.95,2021-07,savings
2021-07-15 00:00:00+00:00,-1.73,37738.68,2021-07,shopping
2021-07-15 00:00:00+00:00,-10.0,37748.68,2021-07,shopping
2021-07-14 00:00:00+00:00,-0.46,37749.14,2021-07,entertainment
2021-07-14 00:00:00+00:00,-44.63,37793.77,2021-07,entertainment
2021-07-14 00:00:00+00:00,74.8,37718.97,2021-07,entertainment
2021-07-12 00:00:00+00:00,-0.41,37719.38,2021-07,savings
2021-07-12 00:00:00+00:00,-16.82,37736.2,2021-07,transport
2021-07-11 00:00:00+00:00,50.0,37686.2,2021-07,finances
2021-07-11 00:00:00+00:00,70.17,37616.03,2021-07,transfer
2021-07-11 00:00:00+00:00,22.42,37593.61,2021-07,taxes
2021-07-11 00:00:00+00:00,-13.78,37607.39,2021-07,holidays
2021-07-10 00:00:00+00:00,-45.0,37652.39,2021-07,finances
2021-07-10 00:00:00+00:00,-5.0,37657.39,2021-07,groceries / food spend
2021-07-10 00:00:00+00:00,40.0,37617.39,2021-07,transfer
2021-07-10 00:00:00+00:00,60.54,37556.85,2021-07,finances
2021-07-10 00:00:00+00:00,-39.97,37596.82,2021-07,transfer
2021-07-10 00:00:00+00:00,-24.5,37621.32,2021-07,bills and utilities
2021-07-09 00:00:00+00:00,-30.93,37652.25,2021-07,transport
2021-07-09 00:00:00+00:00,-20.56,37672.81,2021-07,taxes
2021-07-09 00:00:00+00:00,-0.43,37673.24,2021-07,savings
2021-07-09 00:00:00+00:00,21.75,37651.49,2021-07,transfer
2021-07-08 00:00:00+00:00,-0.01,37651.5,2021-07,savings
2021-07-08 00:00:00+00:00,22.42,37629.08,2021-07,taxes
2021-07-08 00:00:00+00:00,-14.99,37644.07,2021-07,fees and charges
2021-07-08 00:00:00+00:00,-100.0,37744.07,2021-07,rent
2021-07-08 00:00:00+00:00,-10.0,37754.07,2021-07,entertainment
2021-07-08 00:00:00+00:00,-0.69,37754.76,2021-07,savings
2021-07-08 00:00:00+00:00,-1.04,37755.8,2021-07,savings
2021-07-08 00:00:00+00:00,-24.31,37780.11,2021-07,groceries / food spend
2021-07-07 00:00:00+00:00,-86.36,37866.47,2021-07,bills and utilities
2021-07-07 00:00:00+00:00,-1.15,37867.62,2021-07,savings
2021-07-07 00:00:00+00:00,-114.35,37981.97,2021-07,transfer
2021-07-06 00:00:00+00:00,-28.75,38010.72,2021-07,bills and utilities
2021-07-06 00:00:00+00:00,24.18,37986.54,2021-07,taxes
2021-07-06 00:00:00+00:00,11.32,37975.22,2021-07,groceries / food spend
2021-07-06 00:00:00+00:00,-51.58,38026.8,2021-07,bills and utilities
2021-07-06 00:00:00+00:00,1.26,38025.54,2021-07,home and garden
2021-07-06 00:00:00+00:00,346.35,37679.19,2021-07,taxes
2021-07-06 00:00:00+00:00,216.83,37462.36,2021-07,transfer
2021-07-06 00:00:00+00:00,-23.3,37485.66,2021-07,transfer
2021-07-06 00:00:00+00:00,-0.01,37485.67,2021-07,savings
2021-07-06 00:00:00+00:00,-3.13,37488.8,2021-07,shopping
2021-07-05 00:00:00+00:00,-60.0,37548.8,2021-07,transfer
2021-07-05 00:00:00+00:00,-1.89,37550.69,2021-07,savings
2021-07-05 00:00:00+00:00,-5.38,37556.07,2021-07,finances
2021-07-05 00:00:00+00:00,-16.39,37572.46,2021-07,shopping
2021-07-05 00:00:00+00:00,-23.15,37595.61,2021-07,transfer
2021-07-05 00:00:00+00:00,-12.73,37608.34,2021-07,finances
2021-07-05 00:00:00+00:00,-6.37,37614.71,2021-07,groceries / food spend
2021-07-05 00:00:00+00:00,-54.58,37669.29,2021-07,shopping
2021-07-04 00:00:00+00:00,12.39,37656.9,2021-07,transfer
2021-07-04 00:00:00+00:00,90.38,37566.52,2021-07,transfer
2021-07-04 00:00:00+00:00,59.17,37507.35,2021-07,transfer
2021-07-04 00:00:00+00:00,-23.42,37530.77,2021-07,transfer
2021-07-04 00:00:00+00:00,-5.0,37535.77,2021-07,shopping
2021-07-04 00:00:00+00:00,-3.07,37538.84,2021-07,finances
2021-07-04 00:00:00+00:00,-168.5,37707.34,2021-07,transfer
2021-07-04 00:00:00+00:00,100.0,37607.34,2021-07,transfer
2021-07-04 00:00:00+00:00,-3.72,37611.06,2021-07,business services
2021-07-04 00:00:00+00:00,34.84,37576.22,2021-07,transfer
2021-07-04 00:00:00+00:00,-130.0,37706.22,2021-07,rent
2021-07-03 00:00:00+00:00,1.41,37704.81,2021-07,transfer
2021-07-03 00:00:00+00:00,-0.32,37705.13,2021-07,savings
2021-07-03 00:00:00+00:00,149.5,37555.63,2021-07,transfer
2021-07-03 00:00:00+00:00,-2.11,37557.74,2021-07,transfer
2021-07-03 00:00:00+00:00,-23.11,37580.85,2021-07,transport
2021-07-03 00:00:00+00:00,35.49,37545.36,2021-07,entertainment
2021-07-03 00:00:00+00:00,-0.01,37545.37,2021-07,savings
2021-07-03 00:00:00+00:00,-2.99,37548.36,2021-07,entertainment
2021-07-03 00:00:00+00:00,-30.0,37578.36,2021-07,shopping
2021-07-03 00:00:00+00:00,70.05,37508.31,2021-07,transfer
2021-07-03 00:00:00+00:00,-40.0,37548.31,2021-07,transfer
2021-07-03 00:00:00+00:00,-5.0,37553.31,2021-07,groceries / food spend
2021-07-02 00:00:00+00:00,18.68,37534.63,2021-07,transfer
2021-07-02 00:00:00+00:00,-28.02,37562.65,2021-07,transfer
2021-07-02 00:00:00+00:00,8.01,37554.64,2021-07,transfer
2021-07-02 00:00:00+00:00,-0.59,37555.23,2021-07,savings
2021-07-01 00:00:00+00:00,-48.25,37603.48,2021-07,bills and utilities
2021-07-01 00:00:00+00:00,-0.01,37603.49,2021-07,fees and charges
2021-07-01 00:00:00+00:00,-407.5,38010.99,2021-07,transfer
2021-07-01 00:00:00+00:00,-39.99,38050.98,2021-07,groceries / food spend
2021-07-01 00:00:00+00:00,-0.01,38050.99,2021-07,finances
2021-07-01 00:00:00+00:00,-0.01,38051.0,2021-07,shopping
2021-07-01 00:00:00+00:00,-0.01,38051.01,2021-07,shopping
2021-07-01 00:00:00+00:00,-0.01,38051.02,2021-07,groceries / food spend
2021-07-01 00:00:00+00:00,-0.01,38051.03,2021-07,groceries / food spend
2021-07-01 00:00:00+00:00,-0.01,38051.04,2021-07,groceries / food spend
2021-07-01 00:00:00+00:00,-0.02,38051.06,2021-07,groceries / food spend
2021-07-01 00:00:00+00:00,-0.01,38051.07,2021-07,transport
2021-07-01 00:00:00+00:00,-200.0,38251.07,2021-07,restaurants / eating out / delivery
2021-07-01 00:00:00+00:00,-0.03,38251.1,2021-07,home and garden
2021-07-01 00:00:00+00:00,-0.02,38251.12,2021-07,fees and charges
2021-07-01 00:00:00+00:00,-0.01,38251.13,2021-07,transport
2021-07-01 00:00:00+00:00,-0.03,38251.16,2021-07,entertainment
2021-07-01 00:00:00+00:00,-0.01,38251.17,2021-07,fees and charges
2021-07-01 00:00:00+00:00,-24.35,38275.52,2021-07,groceries / food spend
2021-07-01 00:00:00+00:00,-20.91,38296.43,2021-07,transfer
2021-07-01 00:00:00+00:00,-8.56,38304.99,2021-07,business services
2021-07-01 00:00:00+00:00,-8.33,38313.32,2021-07,bills and utilities
2021-07-01 00:00:00+00:00,-8.72,38322.04,2021-07,finances
2021-07-01 00:00:00+00:00,-10.0,38332.04,2021-07,finances
2021-07-01 00:00:00+00:00,-10.0,38342.04,2021-07,bills and utilities
2021-06-28 00:00:00+00:00,420.0,37922.04,2021-06,transfer
2021-06-28 00:00:00+00:00,-5.37,37927.41,2021-06,shopping
2021-06-28 00:00:00+00:00,40.0,37887.41,2021-06,transfer
2021-06-28 00:00:00+00:00,-32.72,37920.13,2021-06,transfer
2021-06-28 00:00:00+00:00,21.07,37899.06,2021-06,taxes
2021-06-27 00:00:00+00:00,-7.93,37906.99,2021-06,transfer
2021-06-27 00:00:00+00:00,50.59,37856.4,2021-06,transfer
2021-06-27 00:00:00+00:00,-0.11,37856.51,2021-06,transfer
2021-06-27 00:00:00+00:00,-27.21,37883.72,2021-06,transport
2021-06-27 00:00:00+00:00,-2.99,37886.71,2021-06,finances
2021-06-27 00:00:00+00:00,11.4,37875.31,2021-06,groceries / food spend
2021-06-27 00:00:00+00:00,-7.56,37882.87,2021-06,shopping
2021-06-25 00:00:00+00:00,70.0,37812.87,2021-06,transfer
2021-06-25 00:00:00+00:00,-24.5,37837.37,2021-06,entertainment
2021-06-25 00:00:00+00:00,-10.0,37847.37,2021-06,transfer
2021-06-25 00:00:00+00:00,-0.41,37847.78,2021-06,savings
2021-06-25 00:00:00+00:00,-32.86,37880.64,2021-06,shopping
2021-06-25 00:00:00+00:00,-0.5,37881.14,2021-06,savings
2021-06-25 00:00:00+00:00,-6.33,37887.47,2021-06,entertainment
2021-06-23 00:00:00+00:00,-30.0,37917.47,2021-06,finances
2021-06-23 00:00:00+00:00,32.5,37884.97,2021-06,transfer
2021-06-23 00:00:00+00:00,-100.0,37984.97,2021-06,transfer
2021-06-23 00:00:00+00:00,-1.57,37986.54,2021-06,savings
2021-06-23 00:00:00+00:00,-30.74,38017.28,2021-06,transfer
2021-06-22 00:00:00+00:00,-5.0,38022.28,2021-06,shopping
2021-06-22 00:00:00+00:00,-0.01,38022.29,2021-06,savings
2021-06-22 00:00:00+00:00,-39.25,38061.54,2021-06,bills and utilities
2021-06-22 00:00:00+00:00,-92.39,38153.93,2021-06,shopping
2021-06-22 00:00:00+00:00,-38.71,38192.64,2021-06,finances
2021-06-20 00:00:00+00:00,-150.0,38342.64,2021-06,rent
2021-06-20 00:00:00+00:00,22.42,38320.22,2021-06,taxes
2021-06-20 00:00:00+00:00,-550.0,38870.22,2021-06,business services
2021-06-20 00:00:00+00:00,338.4,38531.82,2021-06,taxes
2021-06-19 00:00:00+00:00,-3.5,38535.32,2021-06,shopping
2021-06-19 00:00:00+00:00,1450.42,37084.9,2021-06,salary
2021-06-18 00:00:00+00:00,59.16,37025.74,2021-06,finances
2021-06-17 00:00:00+00:00,137.6,36888.14,2021-06,transfer
2021-06-17 00:00:00+00:00,-12.73,36900.87,2021-06,finances
2021-06-17 00:00:00+00:00,-42.06,36942.93,2021-06,finances
2021-06-17 00:00:00+00:00,-20.0,36962.93,2021-06,transport
2021-06-17 00:00:00+00:00,-0.63,36963.56,2021-06,savings
2021-06-17 00:00:00+00:00,-3.19,36966.75,2021-06,groceries / food spend
2021-06-15 00:00:00+00:00,-19.25,36986.0,2021-06,groceries / food spend
2021-06-15 00:00:00+00:00,-0.55,36986.55,2021-06,savings
2021-06-15 00:00:00+00:00,-15.45,37002.0,2021-06,shopping
2021-06-15 00:00:00+00:00,-0.54,37002.54,2021-06,savings
2021-06-15 00:00:00+00:00,-3.59,37006.13,2021-06,shopping
2021-06-15 00:00:00+00:00,-10.0,37016.13,2021-06,shopping
2021-06-14 00:00:00+00:00,-0.14,37016.27,2021-06,entertainment
2021-06-14 00:00:00+00:00,-31.53,37047.8,2021-06,entertainment
2021-06-14 00:00:00+00:00,43.5,37004.3,2021-06,entertainment
2021-06-12 00:00:00+00:00,-0.41,37004.71,2021-06,savings
2021-06-12 00:00:00+00:00,-23.11,37027.82,2021-06,transport
2021-06-11 00:00:00+00:00,47.05,36980.77,2021-06,finances
2021-06-11 00:00:00+00:00,50.0,36930.77,2021-06,transfer
2021-06-11 00:00:00+00:00,22.42,36908.35,2021-06,taxes
2021-06-11 00:00:00+00:00,-37.38,36945.73,2021-06,holidays
2021-06-10 00:00:00+00:00,-33.06,36978.79,2021-06,finances
2021-06-10 00:00:00+00:00,-5.0,36983.79,2021-06,groceries / food spend
2021-06-10 00:00:00+00:00,-6.98,36990.77,2021-06,transfer
2021-06-10 00:00:00+00:00,57.15,36933.62,2021-06,finances
2021-06-10 00:00:00+00:00,-30.0,36963.62,2021-06,transfer
2021-06-10 00:00:00+00:00,-24.5,36988.12,2021-06,bills and utilities
2021-06-09 00:00:00+00:00,-23.62,37011.74,2021-06,transport
2021-06-09 00:00:00+00:00,-20.85,37032.59,2021-06,taxes
2021-06-09 00:00:00+00:00,-0.42,37033.01,2021-06,savings
2021-06-09 00:00:00+00:00,70.0,36963.01,2021-06,transfer
2021-06-08 00:00:00+00:00,-0.01,36963.02,2021-06,savings
2021-06-08 00:00:00+00:00,22.42,36940.6,2021-06,taxes
2021-06-08 00:00:00+00:00,-23.45,36964.05,2021-06,fees and charges
2021-06-08 00:00:00+00:00,-100.0,37064.05,2021-06,rent
2021-06-08 00:00:00+00:00,-12.79,37076.84,2021-06,entertainment
2021-06-08 00:00:00+00:00,-0.69,37077.53,2021-06,savings
2021-06-08 00:00:00+00:00,-1.05,37078.58,2021-06,savings
2021-06-08 00:00:00+00:00,-37.0,37115.58,2021-06,groceries / food spend
2021-06-07 00:00:00+00:00,-82.37,37197.95,2021-06,bills and utilities
2021-06-07 00:00:00+00:00,-1.1,37199.05,2021-06,savings
2021-06-07 00:00:00+00:00,-70.0,37269.05,2021-06,transfer
2021-06-06 00:00:00+00:00,-32.27,37301.32,2021-06,bills and utilities
2021-06-06 00:00:00+00:00,21.73,37279.59,2021-06,taxes
2021-06-06 00:00:00+00:00,-12.89,37292.48,2021-06,groceries / food spend
2021-06-06 00:00:00+00:00,-50.0,37342.48,2021-06,bills and utilities
2021-06-06 00:00:00+00:00,-9.71,37352.19,2021-06,home and garden
2021-06-06 00:00:00+00:00,353.6,36998.59,2021-06,taxes
2021-06-06 00:00:00+00:00,137.6,36860.99,2021-06,transfer
2021-06-06 00:00:00+00:00,47.75,36813.24,2021-06,transfer
2021-06-06 00:00:00+00:00,-0.01,36813.25,2021-06,savings
2021-06-06 00:00:00+00:00,-5.0,36818.25,2021-06,shopping
2021-06-05 00:00:00+00:00,-60.0,36878.25,2021-06,transfer
2021-06-05 00:00:00+00:00,-1.61,36879.86,2021-06,savings
2021-06-05 00:00:00+00:00,-6.46,36886.32,2021-06,finances
2021-06-05 00:00:00+00:00,-7.99,36894.31,2021-06,shopping
2021-06-05 00:00:00+00:00,-23.15,36917.46,2021-06,transfer
2021-06-05 00:00:00+00:00,-11.21,36928.67,2021-06,finances
2021-06-05 00:00:00+00:00,-6.37,36935.04,2021-06,groceries / food spend
2021-06-05 00:00:00+00:00,-15.46,36950.5,2021-06,shopping
2021-06-04 00:00:00+00:00,10.0,36940.5,2021-06,transfer
2021-06-04 00:00:00+00:00,70.0,36870.5,2021-06,transfer
2021-06-04 00:00:00+00:00,59.17,36811.33,2021-06,transfer
2021-06-04 00:00:00+00:00,-20.0,36831.33,2021-06,transfer
2021-06-04 00:00:00+00:00,-5.0,36836.33,2021-06,shopping
2021-06-04 00:00:00+00:00,-3.07,36839.4,2021-06,finances
2021-06-04 00:00:00+00:00,-100.0,36939.4,2021-06,transfer
2021-06-04 00:00:00+00:00,100.0,36839.4,2021-06,transfer
2021-06-04 00:00:00+00:00,-2.12,36841.52,2021-06,business services
2021-06-04 00:00:00+00:00,29.19,36812.33,2021-06,transfer
2021-06-04 00:00:00+00:00,-130.0,36942.33,2021-06,rent
2021-06-03 00:00:00+00:00,0.89,36941.44,2021-06,transfer
2021-06-03 00:00:00+00:00,-0.41,36941.85,2021-06,savings
2021-06-03 00:00:00+00:00,149.79,36792.06,2021-06,transfer
2021-06-03 00:00:00+00:00,4.91,36787.15,2021-06,transfer
2021-06-03 00:00:00+00:00,-23.11,36810.26,2021-06,transport
2021-06-03 00:00:00+00:00,35.49,36774.77,2021-06,entertainment
2021-06-03 00:00:00+00:00,-0.01,36774.78,2021-06,savings
2021-06-03 00:00:00+00:00,-2.99,36777.77,2021-06,entertainment
2021-06-03 00:00:00+00:00,-30.0,36807.77,2021-06,shopping
2021-06-03 00:00:00+00:00,40.0,36767.77,2021-06,transfer
2021-06-03 00:00:00+00:00,-48.02,36815.79,2021-06,transfer
2021-06-03 00:00:00+00:00,-5.0,36820.79,2021-06,groceries / food spend
2021-06-02 00:00:00+00:00,21.8,36798.99,2021-06,transfer
2021-06-02 00:00:00+00:00,-26.99,36825.98,2021-06,transfer
2021-06-02 00:00:00+00:00,12.77,36813.21,2021-06,transfer
2021-06-02 00:00:00+00:00,-0.59,36813.8,2021-06,savings
2021-06-01 00:00:00+00:00,-46.82,36860.62,2021-06,bills and utilities
2021-06-01 00:00:00+00:00,-0.01,36860.63,2021-06,fees and charges
2021-06-01 00:00:00+00:00,-227.0,37087.63,2021-06,transfer
2021-06-01 00:00:00+00:00,-39.99,37127.62,2021-06,groceries / food spend
2021-06-01 00:00:00+00:00,-0.01,37127.63,2021-06,finances
2021-06-01 00:00:00+00:00,-0.01,37127.64,2021-06,shopping
2021-06-01 00:00:00+00:00,-0.01,37127.65,2021-06,shopping
2021-06-01 00:00:00+00:00,-0.0,37127.65,2021-06,groceries / food spend
2021-06-01 00:00:00+00:00,-0.02,37127.67,2021-06,groceries / food spend
2021-06-01 00:00:00+00:00,-0.01,37127.68,2021-06,groceries / food spend
2021-06-01 00:00:00+00:00,-0.01,37127.69,2021-06,groceries / food spend
2021-06-01 00:00:00+00:00,-0.01,37127.7,2021-06,transport
2021-06-01 00:00:00+00:00,-200.0,37327.7,2021-06,restaurants / eating out / delivery
2021-06-01 00:00:00+00:00,-0.01,37327.71,2021-06,home and garden
2021-06-01 00:00:00+00:00,-0.01,37327.72,2021-06,fees and charges
2021-06-01 00:00:00+00:00,-0.01,37327.73,2021-06,transport
2021-06-01 00:00:00+00:00,-0.01,37327.74,2021-06,entertainment
2021-06-01 00:00:00+00:00,-0.01,37327.75,2021-06,fees and charges
2021-06-01 00:00:00+00:00,-2.85,37330.6,2021-06,groceries / food spend
2021-06-01 00:00:00+00:00,-20.91,37351.51,2021-06,transfer
2021-06-01 00:00:00+00:00,-10.0,37361.51,2021-06,business services
2021-06-01 00:00:00+00:00,-10.0,37371.51,2021-06,bills and utilities
2021-06-01 00:00:00+00:00,-12.13,37383.64,2021-06,finances
2021-06-01 00:00:00+00:00,-10.0,37393.64,2021-06,finances
2021-06-01 00:00:00+00:00,-8.42,37402.06,2021-06,bills and utilities
2021-05-28 00:00:00+00:00,420.0,36982.06,2021-05,transfer
2021-05-28 00:00:00+00:00,-22.71,37004.77,2021-05,shopping
2021-05-28 00:00:00+00:00,39.11,36965.66,2021-05,transfer
2021-05-28 00:00:00+00:00,-39.81,37005.47,2021-05,transfer
2021-05-28 00:00:00+00:00,22.25,36983.22,2021-05,taxes
2021-05-27 00:00:00+00:00,-7.93,36991.15,2021-05,transfer
2021-05-27 00:00:00+00:00,50.59,36940.56,2021-05,transfer
2021-05-27 00:00:00+00:00,23.41,36917.15,2021-05,transfer
2021-05-27 00:00:00+00:00,-20.56,36937.71,2021-05,transport
2021-05-27 00:00:00+00:00,-2.39,36940.1,2021-05,finances
2021-05-27 00:00:00+00:00,-40.68,36980.78,2021-05,groceries / food spend
2021-05-27 00:00:00+00:00,-7.56,36988.34,2021-05,shopping
2021-05-25 00:00:00+00:00,70.0,36918.34,2021-05,transfer
2021-05-25 00:00:00+00:00,-27.87,36946.21,2021-05,entertainment
2021-05-25 00:00:00+00:00,-16.42,36962.63,2021-05,transfer
2021-05-25 00:00:00+00:00,-0.41,36963.04,2021-05,savings
2021-05-25 00:00:00+00:00,-36.59,36999.63,2021-05,shopping
2021-05-25 00:00:00+00:00,-0.5,37000.13,2021-05,savings
2021-05-25 00:00:00+00:00,-10.5,37010.63,2021-05,entertainment
2021-05-23 00:00:00+00:00,-28.89,37039.52,2021-05,finances
2021-05-23 00:00:00+00:00,32.5,37007.02,2021-05,transfer
2021-05-23 00:00:00+00:00,-204.46,37211.48,2021-05,transfer
2021-05-23 00:00:00+00:00,-1.57,37213.05,2021-05,savings
2021-05-23 00:00:00+00:00,-13.19,37226.24,2021-05,transfer
2021-05-22 00:00:00+00:00,-5.0,37231.24,2021-05,shopping
2021-05-22 00:00:00+00:00,-0.01,37231.25,2021-05,savings
2021-05-22 00:00:00+00:00,-39.25,37270.5,2021-05,bills and utilities
2021-05-22 00:00:00+00:00,-36.59,37307.09,2021-05,shopping
2021-05-22 00:00:00+00:00,-42.61,37349.7,2021-05,finances
2021-05-20 00:00:00+00:00,-150.0,37499.7,2021-05,rent
2021-05-20 00:00:00+00:00,22.42,37477.28,2021-05,taxes
2021-05-20 00:00:00+00:00,-550.0,38027.28,2021-05,business services
2021-05-20 00:00:00+00:00,345.13,37682.15,2021-05,taxes
2021-05-19 00:00:00+00:00,-7.99,37690.14,2021-05,shopping
2021-05-19 00:00:00+00:00,1450.42,36239.72,2021-05,salary
2021-05-18 00:00:00+00:00,67.66,36172.06,2021-05,finances
2021-05-17 00:00:00+00:00,137.6,36034.46,2021-05,transfer
2021-05-17 00:00:00+00:00,-12.73,36047.19,2021-05,finances
2021-05-17 00:00:00+00:00,-40.0,36087.19,2021-05,finances
2021-05-17 00:00:00+00:00,-26.79,36113.98,2021-05,transport
2021-05-17 00:00:00+00:00,-0.69,36114.67,2021-05,savings
2021-05-17 00:00:00+00:00,-2.31,36116.98,2021-05,groceries / food spend
2021-05-15 00:00:00+00:00,-41.62,36158.6,2021-05,groceries / food spend
2021-05-15 00:00:00+00:00,-0.45,36159.05,2021-05,savings
2021-05-15 00:00:00+00:00,-40.73,36199.78,2021-05,shopping
2021-05-15 00:00:00+00:00,-0.5,36200.28,2021-05,savings
2021-05-15 00:00:00+00:00,-3.59,36203.87,2021-05,shopping
2021-05-15 00:00:00+00:00,-12.19,36216.06,2021-05,shopping
2021-05-14 00:00:00+00:00,-2.0,36218.06,2021-05,entertainment
2021-05-14 00:00:00+00:00,-20.5,36238.56,2021-05,entertainment
2021-05-14 00:00:00+00:00,43.5,36195.06,2021-05,entertainment
2021-05-12 00:00:00+00:00,-0.37,36195.43,2021-05,savings
2021-05-12 00:00:00+00:00,-23.11,36218.54,2021-05,transport
2021-05-11 00:00:00+00:00,50.17,36168.37,2021-05,finances
2021-05-11 00:00:00+00:00,50.0,36118.37,2021-05,transfer
2021-05-11 00:00:00+00:00,22.42,36095.95,2021-05,taxes
2021-05-11 00:00:00+00:00,-17.0,36112.95,2021-05,holidays
2021-05-10 00:00:00+00:00,-40.0,36152.95,2021-05,finances
2021-05-10 00:00:00+00:00,-5.0,36157.95,2021-05,groceries / food spend
2021-05-10 00:00:00+00:00,25.46,36132.49,2021-05,transfer
2021-05-10 00:00:00+00:00,38.3,36094.19,2021-05,finances
2021-05-10 00:00:00+00:00,-17.64,36111.83,2021-05,transfer
2021-05-10 00:00:00+00:00,-28.92,36140.75,2021-05,bills and utilities
2021-05-09 00:00:00+00:00,-23.62,36164.37,2021-05,transport
2021-05-09 00:00:00+00:00,-20.56,36184.93,2021-05,taxes
2021-05-09 00:00:00+00:00,-0.41,36185.34,2021-05,savings
2021-05-09 00:00:00+00:00,133.41,36051.93,2021-05,transfer
2021-05-08 00:00:00+00:00,-0.01,36051.94,2021-05,savings
2021-05-08 00:00:00+00:00,22.42,36029.52,2021-05,taxes
2021-05-08 00:00:00+00:00,-14.99,36044.51,2021-05,fees and charges
2021-05-08 00:00:00+00:00,-100.0,36144.51,2021-05,rent
2021-05-08 00:00:00+00:00,-10.0,36154.51,2021-05,entertainment
2021-05-08 00:00:00+00:00,-0.71,36155.22,2021-05,savings
2021-05-08 00:00:00+00:00,-0.85,36156.07,2021-05,savings
2021-05-08 00:00:00+00:00,-24.31,36180.38,2021-05,groceries / food spend
2021-05-07 00:00:00+00:00,-82.37,36262.75,2021-05,bills and utilities
2021-05-07 00:00:00+00:00,-1.06,36263.81,2021-05,savings
2021-05-07 00:00:00+00:00,-44.48,36308.29,2021-05,transfer
2021-05-06 00:00:00+00:00,-27.31,36335.6,2021-05,bills and utilities
2021-05-06 00:00:00+00:00,22.68,36312.92,2021-05,taxes
2021-05-06 00:00:00+00:00,-16.53,36329.45,2021-05,groceries / food spend
2021-05-06 00:00:00+00:00,-50.0,36379.45,2021-05,bills and utilities
2021-05-06 00:00:00+00:00,-12.07,36391.52,2021-05,home and garden
2021-05-06 00:00:00+00:00,346.35,36045.17,2021-05,taxes
2021-05-06 00:00:00+00:00,109.41,35935.76,2021-05,transfer
2021-05-06 00:00:00+00:00,104.41,35831.35,2021-05,transfer
2021-05-06 00:00:00+00:00,-0.01,35831.36,2021-05,savings
2021-05-06 00:00:00+00:00,-5.0,35836.36,2021-05,shopping
2021-05-05 00:00:00+00:00,-60.0,35896.36,2021-05,transfer
2021-05-05 00:00:00+00:00,-1.74,35898.1,2021-05,savings
2021-05-05 00:00:00+00:00,-5.86,35903.96,2021-05,finances
2021-05-05 00:00:00+00:00,-7.99,35911.95,2021-05,shopping
2021-05-05 00:00:00+00:00,-23.15,35935.1,2021-05,transfer
2021-05-05 00:00:00+00:00,-9.51,35944.61,2021-05,finances
2021-05-05 00:00:00+00:00,-4.28,35948.89,2021-05,groceries / food spend
2021-05-05 00:00:00+00:00,-20.0,35968.89,2021-05,shopping
2021-05-04 00:00:00+00:00,11.02,35957.87,2021-05,transfer
2021-05-04 00:00:00+00:00,70.0,35887.87,2021-05,transfer
2021-05-04 00:00:00+00:00,59.17,35828.7,2021-05,transfer
2021-05-04 00:00:00+00:00,-20.0,35848.7,2021-05,transfer
2021-05-04 00:00:00+00:00,-6.44,35855.14,2021-05,shopping
2021-05-04 00:00:00+00:00,-3.07,35858.21,2021-05,finances
2021-05-04 00:00:00+00:00,-102.63,35960.84,2021-05,transfer
2021-05-04 00:00:00+00:00,100.0,35860.84,2021-05,transfer
2021-05-04 00:00:00+00:00,-6.07,35866.91,2021-05,business services
2021-05-04 00:00:00+00:00,25.0,35841.91,2021-05,transfer
2021-05-04 00:00:00+00:00,-130.0,35971.91,2021-05,rent
2021-05-03 00:00:00+00:00,0.89,35971.02,2021-05,transfer
2021-05-03 00:00:00+00:00,-0.41,35971.43,2021-05,savings
2021-05-03 00:00:00+00:00,130.0,35841.43,2021-05,transfer
2021-05-03 00:00:00+00:00,11.18,35830.25,2021-05,transfer
2021-05-03 00:00:00+00:00,-18.11,35848.36,2021-05,transport
2021-05-03 00:00:00+00:00,54.46,35793.9,2021-05,entertainment
2021-05-03 00:00:00+00:00,-0.01,35793.91,2021-05,savings
2021-05-03 00:00:00+00:00,-5.49,35799.4,2021-05,entertainment
2021-05-03 00:00:00+00:00,-30.0,35829.4,2021-05,shopping
2021-05-03 00:00:00+00:00,40.0,35789.4,2021-05,transfer
2021-05-03 00:00:00+00:00,-40.0,35829.4,2021-05,transfer
2021-05-03 00:00:00+00:00,-8.19,35837.59,2021-05,groceries / food spend
2021-05-02 00:00:00+00:00,30.0,35807.59,2021-05,transfer
2021-05-02 00:00:00+00:00,-30.0,35837.59,2021-05,transfer
2021-05-02 00:00:00+00:00,10.0,35827.59,2021-05,transfer
2021-05-02 00:00:00+00:00,-0.56,35828.15,2021-05,savings
2021-05-01 00:00:00+00:00,-46.82,35874.97,2021-05,bills and utilities
2021-05-01 00:00:00+00:00,-0.01,35874.98,2021-05,fees and charges
2021-05-01 00:00:00+00:00,-167.58,36042.56,2021-05,transfer
2021-05-01 00:00:00+00:00,-39.02,36081.58,2021-05,groceries / food spend
2021-05-01 00:00:00+00:00,-0.01,36081.59,2021-05,finances
2021-05-01 00:00:00+00:00,-0.0,36081.59,2021-05,shopping
2021-05-01 00:00:00+00:00,-0.01,36081.6,2021-05,shopping
2021-05-01 00:00:00+00:00,-0.0,36081.6,2021-05,groceries / food spend
2021-05-01 00:00:00+00:00,-0.01,36081.61,2021-05,groceries / food spend
2021-05-01 00:00:00+00:00,-0.01,36081.62,2021-05,groceries / food spend
2021-05-01 00:00:00+00:00,-0.0,36081.62,2021-05,groceries / food spend
2021-05-01 00:00:00+00:00,-0.01,36081.63,2021-05,transport
2021-05-01 00:00:00+00:00,-200.0,36281.63,2021-05,restaurants / eating out / delivery
2021-05-01 00:00:00+00:00,-0.01,36281.64,2021-05,home and garden
2021-05-01 00:00:00+00:00,-0.01,36281.65,2021-05,fees and charges
2021-05-01 00:00:00+00:00,-0.01,36281.66,2021-05,transport
2021-05-01 00:00:00+00:00,-0.02,36281.68,2021-05,entertainment
2021-05-01 00:00:00+00:00,-0.01,36281.69,2021-05,fees and charges
2021-05-01 00:00:00+00:00,-28.28,36309.97,2021-05,groceries / food spend
2021-05-01 00:00:00+00:00,-33.62,36343.59,2021-05,transfer
2021-05-01 00:00:00+00:00,-11.24,36354.83,2021-05,business services
2021-05-01 00:00:00+00:00,-8.68,36363.51,2021-05,bills and utilities
2021-05-01 00:00:00+00:00,-10.02,36373.53,2021-05,finances
2021-05-01 00:00:00+00:00,-12.17,36385.7,2021-05,finances
2021-05-01 00:00:00+00:00,-10.71,36396.41,2021-05,bills and utilities
2021-04-28 00:00:00+00:00,748.41,35648.0,2021-04,transfer
2021-04-28 00:00:00+00:00,-36.59,35684.59,2021-04,shopping
2021-04-28 00:00:00+00:00,29.27,35655.32,2021-04,transfer
2021-04-28 00:00:00+00:00,-5.97,35661.29,2021-04,transfer
2021-04-28 00:00:00+00:00,22.42,35638.87,2021-04,taxes
2021-04-27 00:00:00+00:00,-3.53,35642.4,2021-04,transfer
2021-04-27 00:00:00+00:00,50.59,35591.81,2021-04,transfer
2021-04-27 00:00:00+00:00,5.81,35586.0,2021-04,transfer
2021-04-27 00:00:00+00:00,-20.56,35606.56,2021-04,transport
2021-04-27 00:00:00+00:00,-2.99,35609.55,2021-04,finances
2021-04-27 00:00:00+00:00,-23.62,35633.17,2021-04,groceries / food spend
2021-04-27 00:00:00+00:00,-4.67,35637.84,2021-04,shopping
2021-04-25 00:00:00+00:00,70.0,35567.84,2021-04,transfer
2021-04-25 00:00:00+00:00,-33.42,35601.26,2021-04,entertainment
2021-04-25 00:00:00+00:00,-14.83,35616.09,2021-04,transfer
2021-04-25 00:00:00+00:00,-0.41,35616.5,2021-04,savings
2021-04-25 00:00:00+00:00,-11.88,35628.38,2021-04,shopping
2021-04-25 00:00:00+00:00,-0.51,35628.89,2021-04,savings
2021-04-25 00:00:00+00:00,-6.2,35635.09,2021-04,entertainment
2021-04-23 00:00:00+00:00,-30.0,35665.09,2021-04,finances
2021-04-23 00:00:00+00:00,20.39,35644.7,2021-04,transfer
2021-04-23 00:00:00+00:00,-196.77,35841.47,2021-04,transfer
2021-04-23 00:00:00+00:00,-1.42,35842.89,2021-04,savings
2021-04-23 00:00:00+00:00,-16.4,35859.29,2021-04,transfer
2021-04-22 00:00:00+00:00,-7.04,35866.33,2021-04,shopping
2021-04-22 00:00:00+00:00,-0.01,35866.34,2021-04,savings
2021-04-22 00:00:00+00:00,-39.25,35905.59,2021-04,bills and utilities
2021-04-22 00:00:00+00:00,-36.59,35942.18,2021-04,shopping
2021-04-22 00:00:00+00:00,-36.59,35978.77,2021-04,finances
2021-04-20 00:00:00+00:00,-150.0,36128.77,2021-04,rent
2021-04-20 00:00:00+00:00,22.42,36106.35,2021-04,taxes
2021-04-20 00:00:00+00:00,-550.0,36656.35,2021-04,business services
2021-04-20 00:00:00+00:00,343.07,36313.28,2021-04,taxes
2021-04-19 00:00:00+00:00,-7.82,36321.1,2021-04,shopping
2021-04-19 00:00:00+00:00,1450.42,34870.68,2021-04,salary
2021-04-18 00:00:00+00:00,82.21,34788.47,2021-04,finances
2021-04-17 00:00:00+00:00,137.6,34650.87,2021-04,transfer
2021-04-17 00:00:00+00:00,-12.87,34663.74,2021-04,finances
2021-04-17 00:00:00+00:00,-40.0,34703.74,2021-04,finances
2021-04-17 00:00:00+00:00,-18.77,34722.51,2021-04,transport
2021-04-17 00:00:00+00:00,-0.61,34723.12,2021-04,savings
2021-04-17 00:00:00+00:00,-6.37,34729.49,2021-04,groceries / food spend
2021-04-15 00:00:00+00:00,-44.34,34773.83,2021-04,groceries / food spend
2021-04-15 00:00:00+00:00,-0.55,34774.38,2021-04,savings
2021-04-15 00:00:00+00:00,-21.72,34796.1,2021-04,shopping
2021-04-15 00:00:00+00:00,-0.5,34796.6,2021-04,savings
2021-04-15 00:00:00+00:00,-6.15,34802.75,2021-04,shopping
2021-04-15 00:00:00+00:00,-10.0,34812.75,2021-04,shopping
2021-04-14 00:00:00+00:00,-2.0,34814.75,2021-04,entertainment
2021-04-14 00:00:00+00:00,-20.5,34835.25,2021-04,entertainment
2021-04-14 00:00:00+00:00,43.5,34791.75,2021-04,entertainment
2021-04-12 00:00:00+00:00,-0.41,34792.16,2021-04,savings
2021-04-12 00:00:00+00:00,-23.11,34815.27,2021-04,transport
2021-04-11 00:00:00+00:00,61.34,34753.93,2021-04,finances
2021-04-11 00:00:00+00:00,41.06,34712.87,2021-04,transfer
2021-04-11 00:00:00+00:00,22.42,34690.45,2021-04,taxes
2021-04-11 00:00:00+00:00,-22.36,34712.81,2021-04,holidays
2021-04-10 00:00:00+00:00,-40.0,34752.81,2021-04,finances
2021-04-10 00:00:00+00:00,-5.0,34757.81,2021-04,groceries / food spend
2021-04-10 00:00:00+00:00,40.0,34717.81,2021-04,transfer
2021-04-10 00:00:00+00:00,74.78,34643.03,2021-04,finances
2021-04-10 00:00:00+00:00,-30.0,34673.03,2021-04,transfer
2021-04-10 00:00:00+00:00,-24.5,34697.53,2021-04,bills and utilities
2021-04-09 00:00:00+00:00,-21.41,34718.94,2021-04,transport
2021-04-09 00:00:00+00:00,-20.56,34739.5,2021-04,taxes
2021-04-09 00:00:00+00:00,-0.41,34739.91,2021-04,savings
2021-04-09 00:00:00+00:00,70.0,34669.91,2021-04,transfer
2021-04-08 00:00:00+00:00,-0.01,34669.92,2021-04,savings
2021-04-08 00:00:00+00:00,22.85,34647.07,2021-04,taxes
2021-04-08 00:00:00+00:00,-17.74,34664.81,2021-04,fees and charges
2021-04-08 00:00:00+00:00,-100.0,34764.81,2021-04,rent
2021-04-08 00:00:00+00:00,-10.0,34774.81,2021-04,entertainment
2021-04-08 00:00:00+00:00,-0.69,34775.5,2021-04,savings
2021-04-08 00:00:00+00:00,-1.04,34776.54,2021-04,savings
2021-04-08 00:00:00+00:00,-24.31,34800.85,2021-04,groceries / food spend
2021-04-07 00:00:00+00:00,-82.37,34883.22,2021-04,bills and utilities
2021-04-07 00:00:00+00:00,-1.15,34884.37,2021-04,savings
2021-04-07 00:00:00+00:00,-38.89,34923.26,2021-04,transfer
2021-04-06 00:00:00+00:00,-28.87,34952.13,2021-04,bills and utilities
2021-04-06 00:00:00+00:00,22.42,34929.71,2021-04,taxes
2021-04-06 00:00:00+00:00,-12.89,34942.6,2021-04,groceries / food spend
2021-04-06 00:00:00+00:00,-49.4,34992.0,2021-04,bills and utilities
2021-04-06 00:00:00+00:00,-6.43,34998.43,2021-04,home and garden
2021-04-06 00:00:00+00:00,344.88,34653.55,2021-04,taxes
2021-04-06 00:00:00+00:00,137.6,34515.95,2021-04,transfer
2021-04-06 00:00:00+00:00,61.89,34454.06,2021-04,transfer
2021-04-06 00:00:00+00:00,-0.01,34454.07,2021-04,savings
2021-04-06 00:00:00+00:00,-5.0,34459.07,2021-04,shopping
2021-04-05 00:00:00+00:00,-60.0,34519.07,2021-04,transfer
2021-04-05 00:00:00+00:00,-1.89,34520.96,2021-04,savings
2021-04-05 00:00:00+00:00,-5.61,34526.57,2021-04,finances
2021-04-05 00:00:00+00:00,-11.23,34537.8,2021-04,shopping
2021-04-05 00:00:00+00:00,-32.67,34570.47,2021-04,transfer
2021-04-05 00:00:00+00:00,-13.52,34583.99,2021-04,finances
2021-04-05 00:00:00+00:00,-3.66,34587.65,2021-04,groceries / food spend
2021-04-05 00:00:00+00:00,-20.0,34607.65,2021-04,shopping
2021-04-04 00:00:00+00:00,9.62,34598.03,2021-04,transfer
2021-04-04 00:00:00+00:00,82.09,34515.94,2021-04,transfer
2021-04-04 00:00:00+00:00,97.46,34418.48,2021-04,transfer
2021-04-04 00:00:00+00:00,-20.0,34438.48,2021-04,transfer
2021-04-04 00:00:00+00:00,-5.0,34443.48,2021-04,shopping
2021-04-04 00:00:00+00:00,-3.07,34446.55,2021-04,finances
2021-04-04 00:00:00+00:00,-100.0,34546.55,2021-04,transfer
2021-04-04 00:00:00+00:00,100.0,34446.55,2021-04,transfer
2021-04-04 00:00:00+00:00,-3.59,34450.14,2021-04,business services
2021-04-04 00:00:00+00:00,25.0,34425.14,2021-04,transfer
2021-04-04 00:00:00+00:00,-130.0,34555.14,2021-04,rent
2021-04-03 00:00:00+00:00,0.89,34554.25,2021-04,transfer
2021-04-03 00:00:00+00:00,-0.37,34554.62,2021-04,savings
2021-04-03 00:00:00+00:00,130.0,34424.62,2021-04,transfer
2021-04-03 00:00:00+00:00,7.18,34417.44,2021-04,transfer
2021-04-03 00:00:00+00:00,-23.11,34440.55,2021-04,transport
2021-04-03 00:00:00+00:00,35.49,34405.06,2021-04,entertainment
2021-04-03 00:00:00+00:00,-0.01,34405.07,2021-04,savings
2021-04-03 00:00:00+00:00,-4.53,34409.6,2021-04,entertainment
2021-04-03 00:00:00+00:00,-42.11,34451.71,2021-04,shopping
2021-04-03 00:00:00+00:00,37.25,34414.46,2021-04,transfer
2021-04-03 00:00:00+00:00,-40.0,34454.46,2021-04,transfer
2021-04-03 00:00:00+00:00,-0.28,34454.74,2021-04,groceries / food spend
2021-04-02 00:00:00+00:00,30.0,34424.74,2021-04,transfer
2021-04-02 00:00:00+00:00,5.08,34419.66,2021-04,transfer
2021-04-02 00:00:00+00:00,10.0,34409.66,2021-04,transfer
2021-04-02 00:00:00+00:00,-0.59,34410.25,2021-04,savings
2021-04-01 00:00:00+00:00,-46.82,34457.07,2021-04,bills and utilities
2021-04-01 00:00:00+00:00,-0.01,34457.08,2021-04,fees and charges
2021-04-01 00:00:00+00:00,48.17,34408.91,2021-04,transfer
2021-04-01 00:00:00+00:00,-39.99,34448.9,2021-04,groceries / food spend
2021-04-01 00:00:00+00:00,-0.01,34448.91,2021-04,finances
2021-04-01 00:00:00+00:00,-0.01,34448.92,2021-04,shopping
2021-04-01 00:00:00+00:00,-0.01,34448.93,2021-04,shopping
2021-04-01 00:00:00+00:00,-0.01,34448.94,2021-04,groceries / food spend
2021-04-01 00:00:00+00:00,-0.01,34448.95,2021-04,groceries / food spend
2021-04-01 00:00:00+00:00,-0.01,34448.96,2021-04,groceries / food spend
2021-04-01 00:00:00+00:00,-0.01,34448.97,2021-04,groceries / food spend
2021-04-01 00:00:00+00:00,-0.01,34448.98,2021-04,transport
2021-04-01 00:00:00+00:00,-200.0,34648.98,2021-04,restaurants / eating out / delivery
2021-04-01 00:00:00+00:00,-0.01,34648.99,2021-04,home and garden
2021-04-01 00:00:00+00:00,-0.0,34648.99,2021-04,fees and charges
2021-04-01 00:00:00+00:00,-0.01,34649.0,2021-04,transport
2021-04-01 00:00:00+00:00,-0.01,34649.01,2021-04,entertainment
2021-04-01 00:00:00+00:00,-0.01,34649.02,2021-04,fees and charges
2021-04-01 00:00:00+00:00,-23.99,34673.01,2021-04,groceries / food spend
2021-04-01 00:00:00+00:00,-14.55,34687.56,2021-04,transfer
2021-04-01 00:00:00+00:00,-10.0,34697.56,2021-04,business services
2021-04-01 00:00:00+00:00,-11.13,34708.69,2021-04,bills and utilities
2021-04-01 00:00:00+00:00,-10.0,34718.69,2021-04,finances
2021-04-01 00:00:00+00:00,-11.81,34730.5,2021-04,finances
2021-04-01 00:00:00+00:00,-9.93,34740.43,2021-04,bills and utilities
2021-03-28 00:00:00+00:00,614.24,34126.19,2021-03,transfer
2021-03-28 00:00:00+00:00,-35.66,34161.85,2021-03,shopping
2021-03-28 00:00:00+00:00,40.0,34121.85,2021-03,transfer
2021-03-28 00:00:00+00:00,-12.98,34134.83,2021-03,transfer
2021-03-28 00:00:00+00:00,22.42,34112.41,2021-03,taxes
2021-03-27 00:00:00+00:00,-7.93,34120.34,2021-03,transfer
2021-03-27 00:00:00+00:00,64.49,34055.85,2021-03,transfer
2021-03-27 00:00:00+00:00,16.71,34039.14,2021-03,transfer
2021-03-27 00:00:00+00:00,-20.36,34059.5,2021-03,transport
2021-03-27 00:00:00+00:00,-2.53,34062.03,2021-03,finances
2021-03-27 00:00:00+00:00,-23.62,34085.65,2021-03,groceries / food spend
2021-03-27 00:00:00+00:00,-3.77,34089.42,2021-03,shopping
2021-03-25 00:00:00+00:00,65.13,34024.29,2021-03,transfer
2021-03-25 00:00:00+00:00,-12.03,34036.32,2021-03,entertainment
2021-03-25 00:00:00+00:00,-18.02,34054.34,2021-03,transfer
2021-03-25 00:00:00+00:00,-0.48,34054.82,2021-03,savings
2021-03-25 00:00:00+00:00,-36.59,34091.41,2021-03,shopping
2021-03-25 00:00:00+00:00,-0.54,34091.95,2021-03,savings
2021-03-25 00:00:00+00:00,-25.03,34116.98,2021-03,entertainment
2021-03-23 00:00:00+00:00,-34.35,34151.33,2021-03,finances
2021-03-23 00:00:00+00:00,47.53,34103.8,2021-03,transfer
2021-03-23 00:00:00+00:00,-100.0,34203.8,2021-03,transfer
2021-03-23 00:00:00+00:00,-1.56,34205.36,2021-03,savings
2021-03-23 00:00:00+00:00,-20.0,34225.36,2021-03,transfer
2021-03-22 00:00:00+00:00,-5.0,34230.36,2021-03,shopping
2021-03-22 00:00:00+00:00,-0.01,34230.37,2021-03,savings
2021-03-22 00:00:00+00:00,-44.06,34274.43,2021-03,bills and utilities
2021-03-22 00:00:00+00:00,-36.59,34311.02,2021-03,shopping
2021-03-22 00:00:00+00:00,-31.29,34342.31,2021-03,finances
2021-03-20 00:00:00+00:00,-150.0,34492.31,2021-03,rent
2021-03-20 00:00:00+00:00,21.83,34470.48,2021-03,taxes
2021-03-20 00:00:00+00:00,-550.0,35020.48,2021-03,business services
2021-03-20 00:00:00+00:00,345.13,34675.35,2021-03,taxes
2021-03-19 00:00:00+00:00,-7.99,34683.34,2021-03,shopping
2021-03-19 00:00:00+00:00,1450.42,33232.92,2021-03,salary
2021-03-18 00:00:00+00:00,82.21,33150.71,2021-03,finances
2021-03-17 00:00:00+00:00,200.79,32949.92,2021-03,transfer
2021-03-17 00:00:00+00:00,-10.25,32960.17,2021-03,finances
2021-03-17 00:00:00+00:00,-40.0,33000.17,2021-03,finances
2021-03-17 00:00:00+00:00,-20.0,33020.17,2021-03,transport
2021-03-17 00:00:00+00:00,-0.63,33020.8,2021-03,savings
2021-03-17 00:00:00+00:00,-6.37,33027.17,2021-03,groceries / food spend
2021-03-15 00:00:00+00:00,-32.0,33059.17,2021-03,groceries / food spend
2021-03-15 00:00:00+00:00,-0.55,33059.72,2021-03,savings
2021-03-15 00:00:00+00:00,-9.25,33068.97,2021-03,shopping
2021-03-15 00:00:00+00:00,-0.5,33069.47,2021-03,savings
2021-03-15 00:00:00+00:00,-4.9,33074.37,2021-03,shopping
2021-03-15 00:00:00+00:00,-7.52,33081.89,2021-03,shopping
2021-03-14 00:00:00+00:00,-2.0,33083.89,2021-03,entertainment
2021-03-14 00:00:00+00:00,-48.97,33132.86,2021-03,entertainment
2021-03-14 00:00:00+00:00,73.62,33059.24,2021-03,entertainment
2021-03-12 00:00:00+00:00,-0.35,33059.59,2021-03,savings
2021-03-12 00:00:00+00:00,-23.11,33082.7,2021-03,transport
2021-03-11 00:00:00+00:00,46.54,33036.16,2021-03,finances
2021-03-11 00:00:00+00:00,50.0,32986.16,2021-03,transfer
2021-03-11 00:00:00+00:00,22.42,32963.74,2021-03,taxes
2021-03-11 00:00:00+00:00,-17.0,32980.74,2021-03,holidays
2021-03-10 00:00:00+00:00,-40.0,33020.74,2021-03,finances
2021-03-10 00:00:00+00:00,-5.0,33025.74,2021-03,groceries / food spend
2021-03-10 00:00:00+00:00,16.45,33009.29,2021-03,transfer
2021-03-10 00:00:00+00:00,37.22,32972.07,2021-03,finances
2021-03-10 00:00:00+00:00,-18.93,32991.0,2021-03,transfer
2021-03-10 00:00:00+00:00,-28.92,33019.92,2021-03,bills and utilities
2021-03-09 00:00:00+00:00,-29.03,33048.95,2021-03,transport
2021-03-09 00:00:00+00:00,-20.56,33069.51,2021-03,taxes
2021-03-09 00:00:00+00:00,-0.48,33069.99,2021-03,savings
2021-03-09 00:00:00+00:00,70.0,32999.99,2021-03,transfer
2021-03-08 00:00:00+00:00,-0.01,33000.0,2021-03,savings
2021-03-08 00:00:00+00:00,22.42,32977.58,2021-03,taxes
2021-03-08 00:00:00+00:00,-14.99,32992.57,2021-03,fees and charges
2021-03-08 00:00:00+00:00,-100.0,33092.57,2021-03,rent
2021-03-08 00:00:00+00:00,-15.0,33107.57,2021-03,entertainment
2021-03-08 00:00:00+00:00,-0.69,33108.26,2021-03,savings
2021-03-08 00:00:00+00:00,-1.04,33109.3,2021-03,savings
2021-03-08 00:00:00+00:00,-46.24,33155.54,2021-03,groceries / food spend
2021-03-07 00:00:00+00:00,-85.95,33241.49,2021-03,bills and utilities
2021-03-07 00:00:00+00:00,-1.3,33242.79,2021-03,savings
2021-03-07 00:00:00+00:00,-8.14,33250.93,2021-03,transfer
2021-03-06 00:00:00+00:00,-29.47,33280.4,2021-03,bills and utilities
2021-03-06 00:00:00+00:00,22.42,33257.98,2021-03,taxes
2021-03-06 00:00:00+00:00,-12.89,33270.87,2021-03,groceries / food spend
2021-03-06 00:00:00+00:00,-50.0,33320.87,2021-03,bills and utilities
2021-03-06 00:00:00+00:00,-9.71,33330.58,2021-03,home and garden
2021-03-06 00:00:00+00:00,346.35,32984.23,2021-03,taxes
2021-03-06 00:00:00+00:00,127.06,32857.17,2021-03,transfer
2021-03-06 00:00:00+00:00,61.89,32795.28,2021-03,transfer
2021-03-06 00:00:00+00:00,-0.01,32795.29,2021-03,savings
2021-03-06 00:00:00+00:00,-4.3,32799.59,2021-03,shopping
2021-03-05 00:00:00+00:00,10.12,32789.47,2021-03,transfer
2021-03-05 00:00:00+00:00,-1.89,32791.36,2021-03,savings
2021-03-05 00:00:00+00:00,-5.79,32797.15,2021-03,finances
2021-03-05 00:00:00+00:00,-17.02,32814.17,2021-03,shopping
2021-03-05 00:00:00+00:00,-23.15,32837.32,2021-03,transfer
2021-03-05 00:00:00+00:00,-12.04,32849.36,2021-03,finances
2021-03-05 00:00:00+00:00,-6.57,32855.93,2021-03,groceries / food spend
2021-03-05 00:00:00+00:00,-20.0,32875.93,2021-03,shopping
2021-03-04 00:00:00+00:00,9.99,32865.94,2021-03,transfer
2021-03-04 00:00:00+00:00,70.0,32795.94,2021-03,transfer
2021-03-04 00:00:00+00:00,59.17,32736.77,2021-03,transfer
2021-03-04 00:00:00+00:00,-20.86,32757.63,2021-03,transfer
2021-03-04 00:00:00+00:00,-7.11,32764.74,2021-03,shopping
2021-03-04 00:00:00+00:00,-2.43,32767.17,2021-03,finances
2021-03-04 00:00:00+00:00,-58.84,32826.01,2021-03,transfer
2021-03-04 00:00:00+00:00,100.0,32726.01,2021-03,transfer
2021-03-04 00:00:00+00:00,-3.59,32729.6,2021-03,business services
2021-03-04 00:00:00+00:00,25.0,32704.6,2021-03,transfer
2021-03-04 00:00:00+00:00,-130.0,32834.6,2021-03,rent
2021-03-03 00:00:00+00:00,1.07,32833.53,2021-03,transfer
2021-03-03 00:00:00+00:00,-0.34,32833.87,2021-03,savings
2021-03-03 00:00:00+00:00,130.0,32703.87,2021-03,transfer
2021-03-03 00:00:00+00:00,7.03,32696.84,2021-03,transfer
2021-03-03 00:00:00+00:00,-36.73,32733.57,2021-03,transport
2021-03-03 00:00:00+00:00,8.47,32725.1,2021-03,entertainment
2021-03-03 00:00:00+00:00,-0.01,32725.11,2021-03,savings
2021-03-03 00:00:00+00:00,-1.88,32726.99,2021-03,entertainment
2021-03-03 00:00:00+00:00,10.99,32716.0,2021-03,shopping
2021-03-03 00:00:00+00:00,32.01,32683.99,2021-03,transfer
2021-03-03 00:00:00+00:00,-43.3,32727.29,2021-03,transfer
2021-03-03 00:00:00+00:00,-9.76,32737.05,2021-03,groceries / food spend
2021-03-02 00:00:00+00:00,30.0,32707.05,2021-03,transfer
2021-03-02 00:00:00+00:00,-14.9,32721.95,2021-03,transfer
2021-03-02 00:00:00+00:00,14.08,32707.87,2021-03,transfer
2021-03-02 00:00:00+00:00,-0.59,32708.46,2021-03,savings
2021-03-01 00:00:00+00:00,-46.82,32755.28,2021-03,bills and utilities
2021-03-01 00:00:00+00:00,-0.01,32755.29,2021-03,fees and charges
2021-03-01 00:00:00+00:00,24.7,32730.59,2021-03,transfer
2021-03-01 00:00:00+00:00,-22.29,32752.88,2021-03,groceries / food spend
2021-03-01 00:00:00+00:00,-0.01,32752.89,2021-03,finances
2021-03-01 00:00:00+00:00,-0.02,32752.91,2021-03,shopping
2021-03-01 00:00:00+00:00,-0.01,32752.92,2021-03,shopping
2021-03-01 00:00:00+00:00,-0.01,32752.93,2021-03,groceries / food spend
2021-03-01 00:00:00+00:00,-0.01,32752.94,2021-03,groceries / food spend
2021-03-01 00:00:00+00:00,-0.0,32752.94,2021-03,groceries / food spend
2021-03-01 00:00:00+00:00,-0.01,32752.95,2021-03,groceries / food spend
2021-03-01 00:00:00+00:00,-0.01,32752.96,2021-03,transport
2021-03-01 00:00:00+00:00,-218.86,32971.82,2021-03,restaurants / eating out / delivery
2021-03-01 00:00:00+00:00,-0.01,32971.83,2021-03,home and garden
2021-03-01 00:00:00+00:00,-0.0,32971.83,2021-03,fees and charges
2021-03-01 00:00:00+00:00,-0.01,32971.84,2021-03,transport
2021-03-01 00:00:00+00:00,-0.01,32971.85,2021-03,entertainment
2021-03-01 00:00:00+00:00,-0.01,32971.86,2021-03,fees and charges
2021-03-01 00:00:00+00:00,-22.38,32994.24,2021-03,groceries / food spend
2021-03-01 00:00:00+00:00,-20.91,33015.15,2021-03,transfer
2021-03-01 00:00:00+00:00,-7.39,33022.54,2021-03,business services
2021-03-01 00:00:00+00:00,-10.0,33032.54,2021-03,bills and utilities
2021-03-01 00:00:00+00:00,-11.62,33044.16,2021-03,finances
2021-03-01 00:00:00+00:00,-10.0,33054.16,2021-03,finances
2021-03-01 00:00:00+00:00,-10.0,33064.16,2021-03,bills and utilities
2021-02-28 00:00:00+00:00,420.0,32644.16,2021-02,transfer
2021-02-28 00:00:00+00:00,-36.59,32680.75,2021-02,shopping
2021-02-28 00:00:00+00:00,16.79,32663.96,2021-02,transfer
2021-02-28 00:00:00+00:00,-49.32,32713.28,2021-02,transfer
2021-02-28 00:00:00+00:00,22.76,32690.52,2021-02,taxes
2021-02-27 00:00:00+00:00,-3.42,32693.94,2021-02,transfer
2021-02-27 00:00:00+00:00,50.59,32643.35,2021-02,transfer
2021-02-27 00:00:00+00:00,21.72,32621.63,2021-02,transfer
2021-02-27 00:00:00+00:00,-20.56,32642.19,2021-02,transport
2021-02-27 00:00:00+00:00,-2.99,32645.18,2021-02,finances
2021-02-27 00:00:00+00:00,13.02,32632.16,2021-02,groceries / food spend
2021-02-27 00:00:00+00:00,-7.56,32639.72,2021-02,shopping
2021-02-25 00:00:00+00:00,70.0,32569.72,2021-02,transfer
2021-02-25 00:00:00+00:00,-24.5,32594.22,2021-02,entertainment
2021-02-25 00:00:00+00:00,-1.71,32595.93,2021-02,transfer
2021-02-25 00:00:00+00:00,-0.41,32596.34,2021-02,savings
2021-02-25 00:00:00+00:00,-39.61,32635.95,2021-02,shopping
2021-02-25 00:00:00+00:00,-0.47,32636.42,2021-02,savings
2021-02-25 00:00:00+00:00,-10.5,32646.92,2021-02,entertainment
2021-02-23 00:00:00+00:00,-34.0,32680.92,2021-02,finances
2021-02-23 00:00:00+00:00,32.5,32648.42,2021-02,transfer
2021-02-23 00:00:00+00:00,-82.63,32731.05,2021-02,transfer
2021-02-23 00:00:00+00:00,-1.68,32732.73,2021-02,savings
2021-02-23 00:00:00+00:00,-33.46,32766.19,2021-02,transfer
2021-02-22 00:00:00+00:00,-5.0,32771.19,2021-02,shopping
2021-02-22 00:00:00+00:00,-0.01,32771.2,2021-02,savings
2021-02-22 00:00:00+00:00,-39.25,32810.45,2021-02,bills and utilities
2021-02-22 00:00:00+00:00,-6.14,32816.59,2021-02,shopping
2021-02-22 00:00:00+00:00,-36.59,32853.18,2021-02,finances
2021-02-20 00:00:00+00:00,-150.0,33003.18,2021-02,rent
2021-02-20 00:00:00+00:00,23.52,32979.66,2021-02,taxes
2021-02-20 00:00:00+00:00,-761.15,33740.81,2021-02,business services
2021-02-20 00:00:00+00:00,355.25,33385.56,2021-02,taxes
2021-02-19 00:00:00+00:00,-8.99,33394.55,2021-02,shopping
2021-02-19 00:00:00+00:00,1450.42,31944.13,2021-02,salary
2021-02-18 00:00:00+00:00,75.02,31869.11,2021-02,finances
2021-02-17 00:00:00+00:00,137.6,31731.51,2021-02,transfer
2021-02-17 00:00:00+00:00,-9.26,31740.77,2021-02,finances
2021-02-17 00:00:00+00:00,-40.0,31780.77,2021-02,finances
2021-02-17 00:00:00+00:00,-31.91,31812.68,2021-02,transport
2021-02-17 00:00:00+00:00,-0.63,31813.31,2021-02,savings
2021-02-17 00:00:00+00:00,-6.37,31819.68,2021-02,groceries / food spend
2021-02-15 00:00:00+00:00,-32.0,31851.68,2021-02,groceries / food spend
2021-02-15 00:00:00+00:00,-0.55,31852.23,2021-02,savings
2021-02-15 00:00:00+00:00,-15.45,31867.68,2021-02,shopping
2021-02-15 00:00:00+00:00,-0.53,31868.21,2021-02,savings
2021-02-15 00:00:00+00:00,-1.35,31869.56,2021-02,shopping
2021-02-15 00:00:00+00:00,-10.0,31879.56,2021-02,shopping
2021-02-14 00:00:00+00:00,-2.0,31881.56,2021-02,entertainment
2021-02-14 00:00:00+00:00,-20.5,31902.06,2021-02,entertainment
2021-02-14 00:00:00+00:00,43.5,31858.56,2021-02,entertainment
2021-02-12 00:00:00+00:00,-0.41,31858.97,2021-02,savings
2021-02-12 00:00:00+00:00,-23.11,31882.08,2021-02,transport
2021-02-11 00:00:00+00:00,49.65,31832.43,2021-02,finances
2021-02-11 00:00:00+00:00,50.0,31782.43,2021-02,transfer
2021-02-11 00:00:00+00:00,22.42,31760.01,2021-02,taxes
2021-02-11 00:00:00+00:00,-13.01,31773.02,2021-02,holidays
2021-02-10 00:00:00+00:00,-35.53,31808.55,2021-02,finances
2021-02-10 00:00:00+00:00,-5.0,31813.55,2021-02,groceries / food spend
2021-02-10 00:00:00+00:00,57.0,31756.55,2021-02,transfer
2021-02-10 00:00:00+00:00,50.36,31706.19,2021-02,finances
2021-02-10 00:00:00+00:00,-8.02,31714.21,2021-02,transfer
2021-02-10 00:00:00+00:00,-24.5,31738.71,2021-02,bills and utilities
2021-02-09 00:00:00+00:00,-15.19,31753.9,2021-02,transport
2021-02-09 00:00:00+00:00,-20.56,31774.46,2021-02,taxes
2021-02-09 00:00:00+00:00,-0.45,31774.91,2021-02,savings
2021-02-09 00:00:00+00:00,70.0,31704.91,2021-02,transfer
2021-02-08 00:00:00+00:00,-0.01,31704.92,2021-02,savings
2021-02-08 00:00:00+00:00,21.99,31682.93,2021-02,taxes
2021-02-08 00:00:00+00:00,-14.99,31697.92,2021-02,fees and charges
2021-02-08 00:00:00+00:00,-100.0,31797.92,2021-02,rent
2021-02-08 00:00:00+00:00,-10.0,31807.92,2021-02,entertainment
2021-02-08 00:00:00+00:00,-0.69,31808.61,2021-02,savings
2021-02-08 00:00:00+00:00,-0.95,31809.56,2021-02,savings
2021-02-08 00:00:00+00:00,-24.31,31833.87,2021-02,groceries / food spend
2021-02-07 00:00:00+00:00,-78.64,31912.51,2021-02,bills and utilities
2021-02-07 00:00:00+00:00,-1.15,31913.66,2021-02,savings
2021-02-07 00:00:00+00:00,-70.0,31983.66,2021-02,transfer
2021-02-06 00:00:00+00:00,-31.63,32015.29,2021-02,bills and utilities
2021-02-06 00:00:00+00:00,23.71,31991.58,2021-02,taxes
2021-02-06 00:00:00+00:00,-12.89,32004.47,2021-02,groceries / food spend
2021-02-06 00:00:00+00:00,-53.74,32058.21,2021-02,bills and utilities
2021-02-06 00:00:00+00:00,6.5,32051.71,2021-02,home and garden
2021-02-06 00:00:00+00:00,344.91,31706.8,2021-02,taxes
2021-02-06 00:00:00+00:00,137.6,31569.2,2021-02,transfer
2021-02-06 00:00:00+00:00,93.07,31476.13,2021-02,transfer
2021-02-06 00:00:00+00:00,-0.01,31476.14,2021-02,savings
2021-02-06 00:00:00+00:00,-5.0,31481.14,2021-02,shopping
2021-02-05 00:00:00+00:00,-60.0,31541.14,2021-02,transfer
2021-02-05 00:00:00+00:00,-1.89,31543.03,2021-02,savings
2021-02-05 00:00:00+00:00,-5.35,31548.38,2021-02,finances
2021-02-05 00:00:00+00:00,-7.99,31556.37,2021-02,shopping
2021-02-05 00:00:00+00:00,-23.15,31579.52,2021-02,transfer
2021-02-05 00:00:00+00:00,-12.73,31592.25,2021-02,finances
2021-02-05 00:00:00+00:00,-6.37,31598.62,2021-02,groceries / food spend
2021-02-05 00:00:00+00:00,-20.84,31619.46,2021-02,shopping
2021-02-04 00:00:00+00:00,5.96,31613.5,2021-02,transfer
2021-02-04 00:00:00+00:00,70.0,31543.5,2021-02,transfer
2021-02-04 00:00:00+00:00,25.64,31517.86,2021-02,transfer
2021-02-04 00:00:00+00:00,-20.0,31537.86,2021-02,transfer
2021-02-04 00:00:00+00:00,-1.99,31539.85,2021-02,shopping
2021-02-04 00:00:00+00:00,-2.75,31542.6,2021-02,finances
2021-02-04 00:00:00+00:00,-100.0,31642.6,2021-02,transfer
2021-02-04 00:00:00+00:00,67.34,31575.26,2021-02,transfer
2021-02-04 00:00:00+00:00,-3.59,31578.85,2021-02,business services
2021-02-04 00:00:00+00:00,25.0,31553.85,2021-02,transfer
2021-02-04 00:00:00+00:00,-130.0,31683.85,2021-02,rent
2021-02-03 00:00:00+00:00,0.89,31682.96,2021-02,transfer
2021-02-03 00:00:00+00:00,-0.41,31683.37,2021-02,savings
2021-02-03 00:00:00+00:00,130.0,31553.37,2021-02,transfer
2021-02-03 00:00:00+00:00,7.0,31546.37,2021-02,transfer
2021-02-03 00:00:00+00:00,-15.99,31562.36,2021-02,transport
2021-02-03 00:00:00+00:00,53.29,31509.07,2021-02,entertainment
2021-02-03 00:00:00+00:00,-0.01,31509.08,2021-02,savings
2021-02-03 00:00:00+00:00,-2.99,31512.07,2021-02,entertainment
2021-02-03 00:00:00+00:00,-36.46,31548.53,2021-02,shopping
2021-02-03 00:00:00+00:00,40.0,31508.53,2021-02,transfer
2021-02-03 00:00:00+00:00,-40.0,31548.53,2021-02,transfer
2021-02-03 00:00:00+00:00,0.05,31548.48,2021-02,groceries / food spend
2021-02-02 00:00:00+00:00,59.78,31488.7,2021-02,transfer
2021-02-02 00:00:00+00:00,-34.24,31522.94,2021-02,transfer
2021-02-02 00:00:00+00:00,9.76,31513.18,2021-02,transfer
2021-02-02 00:00:00+00:00,-0.6,31513.78,2021-02,savings
2021-02-01 00:00:00+00:00,-46.82,31560.6,2021-02,bills and utilities
2021-02-01 00:00:00+00:00,-0.0,31560.6,2021-02,fees and charges
2021-02-01 00:00:00+00:00,-182.95,31743.55,2021-02,transfer
2021-02-01 00:00:00+00:00,-39.99,31783.54,2021-02,groceries / food spend
2021-02-01 00:00:00+00:00,-0.01,31783.55,2021-02,finances
2021-02-01 00:00:00+00:00,0.0,31783.55,2021-02,shopping
2021-02-01 00:00:00+00:00,-0.01,31783.56,2021-02,shopping
2021-02-01 00:00:00+00:00,-0.01,31783.57,2021-02,groceries / food spend
2021-02-01 00:00:00+00:00,-0.01,31783.58,2021-02,groceries / food spend
2021-02-01 00:00:00+00:00,-0.01,31783.59,2021-02,groceries / food spend
2021-02-01 00:00:00+00:00,-0.02,31783.61,2021-02,groceries / food spend
2021-02-01 00:00:00+00:00,-0.01,31783.62,2021-02,transport
2021-02-01 00:00:00+00:00,-200.0,31983.62,2021-02,restaurants / eating out / delivery
2021-02-01 00:00:00+00:00,-0.01,31983.63,2021-02,home and garden
2021-02-01 00:00:00+00:00,-0.01,31983.64,2021-02,fees and charges
2021-02-01 00:00:00+00:00,-0.01,31983.65,2021-02,transport
2021-02-01 00:00:00+00:00,-0.0,31983.65,2021-02,entertainment
2021-02-01 00:00:00+00:00,-0.01,31983.66,2021-02,fees and charges
2021-02-01 00:00:00+00:00,18.6,31965.06,2021-02,groceries / food spend
2021-02-01 00:00:00+00:00,-20.91,31985.97,2021-02,transfer
2021-02-01 00:00:00+00:00,-8.24,31994.21,2021-02,business services
2021-02-01 00:00:00+00:00,-10.96,32005.17,2021-02,bills and utilities
2021-02-01 00:00:00+00:00,-8.88,32014.05,2021-02,finances
2021-02-01 00:00:00+00:00,-6.76,32020.81,2021-02,finances
2021-02-01 00:00:00+00:00,-11.32,32032.13,2021-02,bills and utilities
2021-01-28 00:00:00+00:00,455.63,31576.5,2021-01,transfer
2021-01-28 00:00:00+00:00,-36.59,31613.09,2021-01,shopping
2021-01-28 00:00:00+00:00,40.0,31573.09,2021-01,transfer
2021-01-28 00:00:00+00:00,-4.1,31577.19,2021-01,transfer
2021-01-28 00:00:00+00:00,22.92,31554.27,2021-01,taxes
2021-01-27 00:00:00+00:00,-7.93,31562.2,2021-01,transfer
2021-01-27 00:00:00+00:00,87.96,31474.24,2021-01,transfer
2021-01-27 00:00:00+00:00,10.44,31463.8,2021-01,transfer
2021-01-27 00:00:00+00:00,-17.44,31481.24,2021-01,transport
2021-01-27 00:00:00+00:00,-2.99,31484.23,2021-01,finances
2021-01-27 00:00:00+00:00,-23.62,31507.85,2021-01,groceries / food spend
2021-01-27 00:00:00+00:00,-17.71,31525.56,2021-01,shopping
2021-01-25 00:00:00+00:00,70.0,31455.56,2021-01,transfer
2021-01-25 00:00:00+00:00,-24.5,31480.06,2021-01,entertainment
2021-01-25 00:00:00+00:00,-13.69,31493.75,2021-01,transfer
2021-01-25 00:00:00+00:00,-0.41,31494.16,2021-01,savings
2021-01-25 00:00:00+00:00,-61.81,31555.97,2021-01,shopping
2021-01-25 00:00:00+00:00,-0.51,31556.48,2021-01,savings
2021-01-25 00:00:00+00:00,-12.88,31569.36,2021-01,entertainment
2021-01-23 00:00:00+00:00,-25.2,31594.56,2021-01,finances
2021-01-23 00:00:00+00:00,32.5,31562.06,2021-01,transfer
2021-01-23 00:00:00+00:00,-63.1,31625.16,2021-01,transfer
2021-01-23 00:00:00+00:00,-1.57,31626.73,2021-01,savings
2021-01-23 00:00:00+00:00,-20.67,31647.4,2021-01,transfer
2021-01-22 00:00:00+00:00,-5.0,31652.4,2021-01,shopping
2021-01-22 00:00:00+00:00,-0.01,31652.41,2021-01,savings
2021-01-22 00:00:00+00:00,-44.07,31696.48,2021-01,bills and utilities
2021-01-22 00:00:00+00:00,-36.59,31733.07,2021-01,shopping
2021-01-22 00:00:00+00:00,-43.42,31776.49,2021-01,finances
2021-01-20 00:00:00+00:00,-150.0,31926.49,2021-01,rent
2021-01-20 00:00:00+00:00,21.9,31904.59,2021-01,taxes
2021-01-20 00:00:00+00:00,-650.61,32555.2,2021-01,business services
2021-01-20 00:00:00+00:00,345.13,32210.07,2021-01,taxes
2021-01-19 00:00:00+00:00,-7.31,32217.38,2021-01,shopping
2021-01-19 00:00:00+00:00,1450.42,30766.96,2021-01,salary
2021-01-18 00:00:00+00:00,104.68,30662.28,2021-01,finances
2021-01-17 00:00:00+00:00,137.6,30524.68,2021-01,transfer
2021-01-17 00:00:00+00:00,-12.73,30537.41,2021-01,finances
2021-01-17 00:00:00+00:00,-36.17,30573.58,2021-01,finances
2021-01-17 00:00:00+00:00,-22.26,30595.84,2021-01,transport
2021-01-17 00:00:00+00:00,-0.63,30596.47,2021-01,savings
2021-01-17 00:00:00+00:00,-1.75,30598.22,2021-01,groceries / food spend
2021-01-15 00:00:00+00:00,-20.71,30618.93,2021-01,groceries / food spend
2021-01-15 00:00:00+00:00,-0.55,30619.48,2021-01,savings
2021-01-15 00:00:00+00:00,-15.45,30634.93,2021-01,shopping
2021-01-15 00:00:00+00:00,-0.51,30635.44,2021-01,savings
2021-01-15 00:00:00+00:00,-3.59,30639.03,2021-01,shopping
2021-01-15 00:00:00+00:00,-10.0,30649.03,2021-01,shopping
2021-01-14 00:00:00+00:00,-2.0,30651.03,2021-01,entertainment
2021-01-14 00:00:00+00:00,-23.36,30674.39,2021-01,entertainment
2021-01-14 00:00:00+00:00,12.61,30661.78,2021-01,entertainment
2021-01-12 00:00:00+00:00,-0.41,30662.19,2021-01,savings
2021-01-12 00:00:00+00:00,-23.11,30685.3,2021-01,transport
2021-01-11 00:00:00+00:00,70.56,30614.74,2021-01,finances
2021-01-11 00:00:00+00:00,71.04,30543.7,2021-01,transfer
2021-01-11 00:00:00+00:00,24.24,30519.46,2021-01,taxes
2021-01-11 00:00:00+00:00,-17.0,30536.46,2021-01,holidays
2021-01-10 00:00:00+00:00,-40.0,30576.46,2021-01,finances
2021-01-10 00:00:00+00:00,-2.08,30578.54,2021-01,groceries / food spend
2021-01-10 00:00:00+00:00,36.96,30541.58,2021-01,transfer
2021-01-10 00:00:00+00:00,45.1,30496.48,2021-01,finances
2021-01-10 00:00:00+00:00,-30.0,30526.48,2021-01,transfer
2021-01-10 00:00:00+00:00,-24.5,30550.98,2021-01,bills and utilities
2021-01-09 00:00:00+00:00,-23.62,30574.6,2021-01,transport
2021-01-09 00:00:00+00:00,-20.56,30595.16,2021-01,taxes
2021-01-09 00:00:00+00:00,-0.41,30595.57,2021-01,savings
2021-01-09 00:00:00+00:00,31.13,30564.44,2021-01,transfer
2021-01-08 00:00:00+00:00,-0.01,30564.45,2021-01,savings
2021-01-08 00:00:00+00:00,22.34,30542.11,2021-01,taxes
2021-01-08 00:00:00+00:00,-18.97,30561.08,2021-01,fees and charges
2021-01-08 00:00:00+00:00,-100.0,30661.08,2021-01,rent
2021-01-08 00:00:00+00:00,-9.03,30670.11,2021-01,entertainment
2021-01-08 00:00:00+00:00,-0.69,30670.8,2021-01,savings
2021-01-08 00:00:00+00:00,-1.04,30671.84,2021-01,savings
2021-01-08 00:00:00+00:00,-24.31,30696.15,2021-01,groceries / food spend
2021-01-07 00:00:00+00:00,-75.01,30771.16,2021-01,bills and utilities
2021-01-07 00:00:00+00:00,-1.26,30772.42,2021-01,savings
2021-01-07 00:00:00+00:00,-55.53,30827.95,2021-01,transfer
2021-01-06 00:00:00+00:00,-29.39,30857.34,2021-01,bills and utilities
2021-01-06 00:00:00+00:00,22.42,30834.92,2021-01,taxes
2021-01-06 00:00:00+00:00,-12.89,30847.81,2021-01,groceries / food spend
2021-01-06 00:00:00+00:00,-50.0,30897.81,2021-01,bills and utilities
2021-01-06 00:00:00+00:00,-9.71,30907.52,2021-01,home and garden
2021-01-06 00:00:00+00:00,346.35,30561.17,2021-01,taxes
2021-01-06 00:00:00+00:00,137.6,30423.57,2021-01,transfer
2021-01-06 00:00:00+00:00,61.89,30361.68,2021-01,transfer
2021-01-06 00:00:00+00:00,-0.01,30361.69,2021-01,savings
2021-01-06 00:00:00+00:00,-5.0,30366.69,2021-01,shopping
2021-01-05 00:00:00+00:00,-60.0,30426.69,2021-01,transfer
2021-01-05 00:00:00+00:00,-1.89,30428.58,2021-01,savings
2021-01-05 00:00:00+00:00,-5.79,30434.37,2021-01,finances
2021-01-05 00:00:00+00:00,-7.99,30442.36,2021-01,shopping
2021-01-05 00:00:00+00:00,-23.15,30465.51,2021-01,transfer
2021-01-05 00:00:00+00:00,-12.73,30478.24,2021-01,finances
2021-01-05 00:00:00+00:00,-7.41,30485.65,2021-01,groceries / food spend
2021-01-05 00:00:00+00:00,-20.0,30505.65,2021-01,shopping
2021-01-04 00:00:00+00:00,10.0,30495.65,2021-01,transfer
2021-01-04 00:00:00+00:00,70.0,30425.65,2021-01,transfer
2021-01-04 00:00:00+00:00,51.74,30373.91,2021-01,transfer
2021-01-04 00:00:00+00:00,-20.0,30393.91,2021-01,transfer
2021-01-04 00:00:00+00:00,-5.0,30398.91,2021-01,shopping
2021-01-04 00:00:00+00:00,-3.07,30401.98,2021-01,finances
2021-01-04 00:00:00+00:00,-100.0,30501.98,2021-01,transfer
2021-01-04 00:00:00+00:00,192.07,30309.91,2021-01,transfer
2021-01-04 00:00:00+00:00,-3.59,30313.5,2021-01,business services
2021-01-04 00:00:00+00:00,25.0,30288.5,2021-01,transfer
2021-01-04 00:00:00+00:00,-130.0,30418.5,2021-01,rent
2021-01-03 00:00:00+00:00,0.89,30417.61,2021-01,transfer
2021-01-03 00:00:00+00:00,-0.38,30417.99,2021-01,savings
2021-01-03 00:00:00+00:00,130.0,30287.99,2021-01,transfer
2021-01-03 00:00:00+00:00,8.81,30279.18,2021-01,transfer
2021-01-03 00:00:00+00:00,-19.97,30299.15,2021-01,transport
2021-01-03 00:00:00+00:00,40.4,30258.75,2021-01,entertainment
2021-01-03 00:00:00+00:00,-0.01,30258.76,2021-01,savings
2021-01-03 00:00:00+00:00,-2.99,30261.75,2021-01,entertainment
2021-01-03 00:00:00+00:00,-36.29,30298.04,2021-01,shopping
2021-01-03 00:00:00+00:00,30.87,30267.17,2021-01,transfer
2021-01-03 00:00:00+00:00,11.46,30255.71,2021-01,transfer
2021-01-03 00:00:00+00:00,-5.0,30260.71,2021-01,groceries / food spend
2021-01-02 00:00:00+00:00,30.0,30230.71,2021-01,transfer
2021-01-02 00:00:00+00:00,-26.76,30257.47,2021-01,transfer
2021-01-02 00:00:00+00:00,13.89,30243.58,2021-01,transfer
2021-01-02 00:00:00+00:00,-0.53,30244.11,2021-01,savings
2021-01-01 00:00:00+00:00,-46.82,30290.93,2021-01,bills and utilities
2021-01-01 00:00:00+00:00,-0.01,30290.94,2021-01,fees and charges
2021-01-01 00:00:00+00:00,-220.48,30511.42,2021-01,transfer
2021-01-01 00:00:00+00:00,-24.43,30535.85,2021-01,groceries / food spend
2021-01-01 00:00:00+00:00,-0.01,30535.86,2021-01,finances
2021-01-01 00:00:00+00:00,-0.0,30535.86,2021-01,shopping
2021-01-01 00:00:00+00:00,-0.01,30535.87,2021-01,shopping
2021-01-01 00:00:00+00:00,-0.01,30535.88,2021-01,groceries / food spend
2021-01-01 00:00:00+00:00,-0.01,30535.89,2021-01,groceries / food spend
2021-01-01 00:00:00+00:00,-0.01,30535.9,2021-01,groceries / food spend
2021-01-01 00:00:00+00:00,-0.01,30535.91,2021-01,groceries / food spend
2021-01-01 00:00:00+00:00,-0.01,30535.92,2021-01,transport
2021-01-01 00:00:00+00:00,-200.0,30735.92,2021-01,restaurants / eating out / delivery
2021-01-01 00:00:00+00:00,-0.02,30735.94,2021-01,home and garden
2021-01-01 00:00:00+00:00,-0.01,30735.95,2021-01,fees and charges
2021-01-01 00:00:00+00:00,-0.01,30735.96,2021-01,transport
2021-01-01 00:00:00+00:00,-0.01,30735.97,2021-01,entertainment
2021-01-01 00:00:00+00:00,0.0,30735.97,2021-01,fees and charges
2021-01-01 00:00:00+00:00,-10.99,30746.96,2021-01,groceries / food spend
2021-01-01 00:00:00+00:00,-4.81,30751.77,2021-01,transfer
2021-01-01 00:00:00+00:00,-10.0,30761.77,2021-01,business services
2021-01-01 00:00:00+00:00,-10.0,30771.77,2021-01,bills and utilities
2021-01-01 00:00:00+00:00,-10.96,30782.73,2021-01,finances
2021-01-01 00:00:00+00:00,-10.0,30792.73,2021-01,finances
2021-01-01 00:00:00+00:00,-8.69,30801.42,2021-01,bills and utilities
2020-12-28 00:00:00+00:00,420.0,30381.42,2020-12,transfer
2020-12-28 00:00:00+00:00,3.3,30378.12,2020-12,shopping
2020-12-28 00:00:00+00:00,40.0,30338.12,2020-12,transfer
2020-12-28 00:00:00+00:00,-32.72,30370.84,2020-12,transfer
2020-12-28 00:00:00+00:00,22.15,30348.69,2020-12,taxes
2020-12-27 00:00:00+00:00,-9.06,30357.75,2020-12,transfer
2020-12-27 00:00:00+00:00,50.59,30307.16,2020-12,transfer
2020-12-27 00:00:00+00:00,15.86,30291.3,2020-12,transfer
2020-12-27 00:00:00+00:00,-20.56,30311.86,2020-12,transport
2020-12-27 00:00:00+00:00,-1.72,30313.58,2020-12,finances
2020-12-27 00:00:00+00:00,-32.64,30346.22,2020-12,groceries / food spend
2020-12-27 00:00:00+00:00,-11.11,30357.33,2020-12,shopping
2020-12-25 00:00:00+00:00,70.0,30287.33,2020-12,transfer
2020-12-25 00:00:00+00:00,-24.5,30311.83,2020-12,entertainment
2020-12-25 00:00:00+00:00,-3.21,30315.04,2020-12,transfer
2020-12-25 00:00:00+00:00,-0.4,30315.44,2020-12,savings
2020-12-25 00:00:00+00:00,-36.59,30352.03,2020-12,shopping
2020-12-25 00:00:00+00:00,-0.5,30352.53,2020-12,savings
2020-12-25 00:00:00+00:00,-10.5,30363.03,2020-12,entertainment
2020-12-23 00:00:00+00:00,-30.0,30393.03,2020-12,finances
2020-12-23 00:00:00+00:00,29.98,30363.05,2020-12,transfer
2020-12-23 00:00:00+00:00,-100.0,30463.05,2020-12,transfer
2020-12-23 00:00:00+00:00,-1.57,30464.62,2020-12,savings
2020-12-23 00:00:00+00:00,-11.46,30476.08,2020-12,transfer
2020-12-22 00:00:00+00:00,-3.4,30479.48,2020-12,shopping
2020-12-22 00:00:00+00:00,-0.01,30479.49,2020-12,savings
2020-12-22 00:00:00+00:00,-42.86,30522.35,2020-12,bills and utilities
2020-12-22 00:00:00+00:00,-13.2,30535.55,2020-12,shopping
2020-12-22 00:00:00+00:00,-36.59,30572.14,2020-12,finances
2020-12-20 00:00:00+00:00,-150.0,30722.14,2020-12,rent
2020-12-20 00:00:00+00:00,22.42,30699.72,2020-12,taxes
2020-12-20 00:00:00+00:00,-550.0,31249.72,2020-12,business services
2020-12-20 00:00:00+00:00,345.13,30904.59,2020-12,taxes
2020-12-19 00:00:00+00:00,-6.73,30911.32,2020-12,shopping
2020-12-19 00:00:00+00:00,1450.42,29460.9,2020-12,salary
2020-12-18 00:00:00+00:00,78.03,29382.87,2020-12,finances
2020-12-17 00:00:00+00:00,137.6,29245.27,2020-12,transfer
2020-12-17 00:00:00+00:00,-12.73,29258.0,2020-12,finances
2020-12-17 00:00:00+00:00,-40.0,29298.0,2020-12,finances
2020-12-17 00:00:00+00:00,-27.67,29325.67,2020-12,transport
2020-12-17 00:00:00+00:00,-0.59,29326.26,2020-12,savings
2020-12-17 00:00:00+00:00,-9.46,29335.72,2020-12,groceries / food spend
2020-12-15 00:00:00+00:00,-32.0,29367.72,2020-12,groceries / food spend
2020-12-15 00:00:00+00:00,-0.55,29368.27,2020-12,savings
2020-12-15 00:00:00+00:00,-16.79,29385.06,2020-12,shopping
2020-12-15 00:00:00+00:00,-0.5,29385.56,2020-12,savings
2020-12-15 00:00:00+00:00,-3.59,29389.15,2020-12,shopping
2020-12-15 00:00:00+00:00,-10.0,29399.15,2020-12,shopping
2020-12-14 00:00:00+00:00,-3.41,29402.56,2020-12,entertainment
2020-12-14 00:00:00+00:00,-1.38,29403.94,2020-12,entertainment
2020-12-14 00:00:00+00:00,43.45,29360.49,2020-12,entertainment
2020-12-12 00:00:00+00:00,-0.41,29360.9,2020-12,savings
2020-12-12 00:00:00+00:00,-23.11,29384.01,2020-12,transport
2020-12-11 00:00:00+00:00,50.0,29334.01,2020-12,finances
2020-12-11 00:00:00+00:00,7.66,29326.35,2020-12,transfer
2020-12-11 00:00:00+00:00,23.47,29302.88,2020-12,taxes
2020-12-11 00:00:00+00:00,-17.0,29319.88,2020-12,holidays
2020-12-10 00:00:00+00:00,-40.0,29359.88,2020-12,finances
2020-12-10 00:00:00+00:00,-3.63,29363.51,2020-12,groceries / food spend
2020-12-10 00:00:00+00:00,40.0,29323.51,2020-12,transfer
2020-12-10 00:00:00+00:00,50.36,29273.15,2020-12,finances
2020-12-10 00:00:00+00:00,-37.3,29310.45,2020-12,transfer
2020-12-10 00:00:00+00:00,-22.5,29332.95,2020-12,bills and utilities
2020-12-09 00:00:00+00:00,-23.62,29356.57,2020-12,transport
2020-12-09 00:00:00+00:00,-20.29,29376.86,2020-12,taxes
2020-12-09 00:00:00+00:00,-0.41,29377.27,2020-12,savings
2020-12-09 00:00:00+00:00,70.0,29307.27,2020-12,transfer
2020-12-08 00:00:00+00:00,-0.01,29307.28,2020-12,savings
2020-12-08 00:00:00+00:00,22.42,29284.86,2020-12,taxes
2020-12-08 00:00:00+00:00,-19.15,29304.01,2020-12,fees and charges
2020-12-08 00:00:00+00:00,-100.0,29404.01,2020-12,rent
2020-12-08 00:00:00+00:00,-10.0,29414.01,2020-12,entertainment
2020-12-08 00:00:00+00:00,-0.67,29414.68,2020-12,savings
2020-12-08 00:00:00+00:00,-1.11,29415.79,2020-12,savings
2020-12-08 00:00:00+00:00,-20.33,29436.12,2020-12,groceries / food spend
2020-12-07 00:00:00+00:00,-82.37,29518.49,2020-12,bills and utilities
2020-12-07 00:00:00+00:00,-1.15,29519.64,2020-12,savings
2020-12-07 00:00:00+00:00,-38.07,29557.71,2020-12,transfer
2020-12-06 00:00:00+00:00,-25.3,29583.01,2020-12,bills and utilities
2020-12-06 00:00:00+00:00,22.42,29560.59,2020-12,taxes
2020-12-06 00:00:00+00:00,-17.59,29578.18,2020-12,groceries / food spend
2020-12-06 00:00:00+00:00,-50.0,29628.18,2020-12,bills and utilities
2020-12-06 00:00:00+00:00,-9.71,29637.89,2020-12,home and garden
2020-12-06 00:00:00+00:00,326.86,29311.03,2020-12,taxes
2020-12-06 00:00:00+00:00,208.5,29102.53,2020-12,transfer
2020-12-06 00:00:00+00:00,97.07,29005.46,2020-12,transfer
2020-12-06 00:00:00+00:00,-0.01,29005.47,2020-12,savings
2020-12-06 00:00:00+00:00,-3.74,29009.21,2020-12,shopping
2020-12-05 00:00:00+00:00,-60.0,29069.21,2020-12,transfer
2020-12-05 00:00:00+00:00,-1.89,29071.1,2020-12,savings
2020-12-05 00:00:00+00:00,-7.19,29078.29,2020-12,finances
2020-12-05 00:00:00+00:00,-7.99,29086.28,2020-12,shopping
2020-12-05 00:00:00+00:00,-21.81,29108.09,2020-12,transfer
2020-12-05 00:00:00+00:00,-12.78,29120.87,2020-12,finances
2020-12-05 00:00:00+00:00,-6.37,29127.24,2020-12,groceries / food spend
2020-12-05 00:00:00+00:00,-20.0,29147.24,2020-12,shopping
2020-12-04 00:00:00+00:00,10.0,29137.24,2020-12,transfer
2020-12-04 00:00:00+00:00,70.0,29067.24,2020-12,transfer
2020-12-04 00:00:00+00:00,59.17,29008.07,2020-12,transfer
2020-12-04 00:00:00+00:00,-9.15,29017.22,2020-12,transfer
2020-12-04 00:00:00+00:00,-5.0,29022.22,2020-12,shopping
2020-12-04 00:00:00+00:00,-2.62,29024.84,2020-12,finances
2020-12-04 00:00:00+00:00,-138.29,29163.13,2020-12,transfer
2020-12-04 00:00:00+00:00,100.0,29063.13,2020-12,transfer
2020-12-04 00:00:00+00:00,-3.59,29066.72,2020-12,business services
2020-12-04 00:00:00+00:00,29.39,29037.33,2020-12,transfer
2020-12-04 00:00:00+00:00,-130.0,29167.33,2020-12,rent
2020-12-03 00:00:00+00:00,0.89,29166.44,2020-12,transfer
2020-12-03 00:00:00+00:00,-0.31,29166.75,2020-12,savings
2020-12-03 00:00:00+00:00,130.0,29036.75,2020-12,transfer
2020-12-03 00:00:00+00:00,9.91,29026.84,2020-12,transfer
2020-12-03 00:00:00+00:00,-28.19,29055.03,2020-12,transport
2020-12-03 00:00:00+00:00,35.49,29019.54,2020-12,entertainment
2020-12-03 00:00:00+00:00,-0.01,29019.55,2020-12,savings
2020-12-03 00:00:00+00:00,-3.7,29023.25,2020-12,entertainment
2020-12-03 00:00:00+00:00,-30.0,29053.25,2020-12,shopping
2020-12-03 00:00:00+00:00,40.0,29013.25,2020-12,transfer
2020-12-03 00:00:00+00:00,-79.77,29093.02,2020-12,transfer
2020-12-03 00:00:00+00:00,-5.0,29098.02,2020-12,groceries / food spend
2020-12-02 00:00:00+00:00,26.67,29071.35,2020-12,transfer
2020-12-02 00:00:00+00:00,-0.17,29071.52,2020-12,transfer
2020-12-02 00:00:00+00:00,10.0,29061.52,2020-12,transfer
2020-12-02 00:00:00+00:00,-0.59,29062.11,2020-12,savings
2020-12-01 00:00:00+00:00,-48.48,29110.59,2020-12,bills and utilities
2020-12-01 00:00:00+00:00,-0.01,29110.6,2020-12,fees and charges
2020-12-01 00:00:00+00:00,-227.0,29337.6,2020-12,transfer
2020-12-01 00:00:00+00:00,-39.99,29377.59,2020-12,groceries / food spend
2020-12-01 00:00:00+00:00,-0.01,29377.6,2020-12,finances
2020-12-01 00:00:00+00:00,-0.01,29377.61,2020-12,shopping
2020-12-01 00:00:00+00:00,-0.01,29377.62,2020-12,shopping
2020-12-01 00:00:00+00:00,-0.01,29377.63,2020-12,groceries / food spend
2020-12-01 00:00:00+00:00,-0.0,29377.63,2020-12,groceries / food spend
2020-12-01 00:00:00+00:00,-0.01,29377.64,2020-12,groceries / food spend
2020-12-01 00:00:00+00:00,0.01,29377.63,2020-12,groceries / food spend
2020-12-01 00:00:00+00:00,-0.01,29377.64,2020-12,transport
2020-12-01 00:00:00+00:00,-116.68,29494.32,2020-12,restaurants / eating out / delivery
2020-12-01 00:00:00+00:00,-0.01,29494.33,2020-12,home and garden
2020-12-01 00:00:00+00:00,-0.01,29494.34,2020-12,fees and charges
2020-12-01 00:00:00+00:00,-0.01,29494.35,2020-12,transport
2020-12-01 00:00:00+00:00,-0.01,29494.36,2020-12,entertainment
2020-12-01 00:00:00+00:00,-0.01,29494.37,2020-12,fees and charges
2020-12-01 00:00:00+00:00,-23.99,29518.36,2020-12,groceries / food spend
2020-12-01 00:00:00+00:00,-22.41,29540.77,2020-12,transfer
2020-12-01 00:00:00+00:00,-10.0,29550.77,2020-12,business services
2020-12-01 00:00:00+00:00,-10.65,29561.42,2020-12,bills and utilities
2020-12-01 00:00:00+00:00,-10.0,29571.42,2020-12,finances
2020-12-01 00:00:00+00:00,-10.0,29581.42,2020-12,finances
2020-12-01 00:00:00+00:00,-11.24,29592.66,2020-12,bills and utilities
2020-11-28 00:00:00+00:00,-116.39,29709.05,2020-11,transfer
2020-11-28 00:00:00+00:00,-36.59,29745.64,2020-11,shopping
2020-11-28 00:00:00+00:00,96.77,29648.87,2020-11,transfer
2020-11-28 00:00:00+00:00,-32.72,29681.59,2020-11,transfer
2020-11-28 00:00:00+00:00,22.42,29659.17,2020-11,taxes
2020-11-27 00:00:00+00:00,-13.24,29672.41,2020-11,transfer
2020-11-27 00:00:00+00:00,66.48,29605.93,2020-11,transfer
2020-11-27 00:00:00+00:00,21.49,29584.44,2020-11,transfer
2020-11-27 00:00:00+00:00,-22.95,29607.39,2020-11,transport
2020-11-27 00:00:00+00:00,-3.09,29610.48,2020-11,finances
2020-11-27 00:00:00+00:00,-23.62,29634.1,2020-11,groceries / food spend
2020-11-27 00:00:00+00:00,-7.56,29641.66,2020-11,shopping
2020-11-25 00:00:00+00:00,70.0,29571.66,2020-11,transfer
2020-11-25 00:00:00+00:00,-12.95,29584.61,2020-11,entertainment
2020-11-25 00:00:00+00:00,-11.46,29596.07,2020-11,transfer
2020-11-25 00:00:00+00:00,-0.41,29596.48,2020-11,savings
2020-11-25 00:00:00+00:00,-36.59,29633.07,2020-11,shopping
2020-11-25 00:00:00+00:00,-0.5,29633.57,2020-11,savings
2020-11-25 00:00:00+00:00,-11.52,29645.09,2020-11,entertainment
2020-11-23 00:00:00+00:00,-42.49,29687.58,2020-11,finances
2020-11-23 00:00:00+00:00,35.03,29652.55,2020-11,transfer
2020-11-23 00:00:00+00:00,-184.4,29836.95,2020-11,transfer
2020-11-23 00:00:00+00:00,-1.75,29838.7,2020-11,savings
2020-11-23 00:00:00+00:00,-17.04,29855.74,2020-11,transfer
2020-11-22 00:00:00+00:00,-5.0,29860.74,2020-11,shopping
2020-11-22 00:00:00+00:00,-0.01,29860.75,2020-11,savings
2020-11-22 00:00:00+00:00,-39.25,29900.0,2020-11,bills and utilities
2020-11-22 00:00:00+00:00,-17.03,29917.03,2020-11,shopping
2020-11-22 00:00:00+00:00,-30.58,29947.61,2020-11,finances
2020-11-20 00:00:00+00:00,-150.0,30097.61,2020-11,rent
2020-11-20 00:00:00+00:00,23.53,30074.08,2020-11,taxes
2020-11-20 00:00:00+00:00,-543.19,30617.27,2020-11,business services
2020-11-20 00:00:00+00:00,321.83,30295.44,2020-11,taxes
2020-11-19 00:00:00+00:00,-7.99,30303.43,2020-11,shopping
2020-11-19 00:00:00+00:00,1450.42,28853.01,2020-11,salary
2020-11-18 00:00:00+00:00,85.9,28767.11,2020-11,finances
2020-11-17 00:00:00+00:00,145.72,28621.39,2020-11,transfer
2020-11-17 00:00:00+00:00,-12.73,28634.12,2020-11,finances
2020-11-17 00:00:00+00:00,-40.0,28674.12,2020-11,finances
2020-11-17 00:00:00+00:00,-14.14,28688.26,2020-11,transport
2020-11-17 00:00:00+00:00,-0.63,28688.89,2020-11,savings
2020-11-17 00:00:00+00:00,-6.37,28695.26,2020-11,groceries / food spend
2020-11-15 00:00:00+00:00,-32.0,28727.26,2020-11,groceries / food spend
2020-11-15 00:00:00+00:00,-0.49,28727.75,2020-11,savings
2020-11-15 00:00:00+00:00,-18.18,28745.93,2020-11,shopping
2020-11-15 00:00:00+00:00,-0.5,28746.43,2020-11,savings
2020-11-15 00:00:00+00:00,-3.59,28750.02,2020-11,shopping
2020-11-15 00:00:00+00:00,2.15,28747.87,2020-11,shopping
2020-11-14 00:00:00+00:00,-2.0,28749.87,2020-11,entertainment
2020-11-14 00:00:00+00:00,-12.68,28762.55,2020-11,entertainment
2020-11-14 00:00:00+00:00,43.5,28719.05,2020-11,entertainment
2020-11-12 00:00:00+00:00,-0.42,28719.47,2020-11,savings
2020-11-12 00:00:00+00:00,-23.11,28742.58,2020-11,transport
2020-11-11 00:00:00+00:00,49.75,28692.83,2020-11,finances
2020-11-11 00:00:00+00:00,50.0,28642.83,2020-11,transfer
2020-11-11 00:00:00+00:00,22.42,28620.41,2020-11,taxes
2020-11-11 00:00:00+00:00,2.61,28617.8,2020-11,holidays
2020-11-10 00:00:00+00:00,-45.95,28663.75,2020-11,finances
2020-11-10 00:00:00+00:00,-5.0,28668.75,2020-11,groceries / food spend
2020-11-10 00:00:00+00:00,40.0,28628.75,2020-11,transfer
2020-11-10 00:00:00+00:00,56.13,28572.62,2020-11,finances
2020-11-10 00:00:00+00:00,-37.92,28610.54,2020-11,transfer
2020-11-10 00:00:00+00:00,-27.65,28638.19,2020-11,bills and utilities
2020-11-09 00:00:00+00:00,-23.62,28661.81,2020-11,transport
2020-11-09 00:00:00+00:00,-19.77,28681.58,2020-11,taxes
2020-11-09 00:00:00+00:00,-0.41,28681.99,2020-11,savings
2020-11-09 00:00:00+00:00,70.0,28611.99,2020-11,transfer
2020-11-08 00:00:00+00:00,-0.01,28612.0,2020-11,savings
2020-11-08 00:00:00+00:00,22.42,28589.58,2020-11,taxes
2020-11-08 00:00:00+00:00,-14.99,28604.57,2020-11,fees and charges
2020-11-08 00:00:00+00:00,-100.0,28704.57,2020-11,rent
2020-11-08 00:00:00+00:00,-10.0,28714.57,2020-11,entertainment
2020-11-08 00:00:00+00:00,-0.69,28715.26,2020-11,savings
2020-11-08 00:00:00+00:00,-1.04,28716.3,2020-11,savings
2020-11-08 00:00:00+00:00,-82.99,28799.29,2020-11,groceries / food spend
2020-11-07 00:00:00+00:00,-82.37,28881.66,2020-11,bills and utilities
2020-11-07 00:00:00+00:00,-1.15,28882.81,2020-11,savings
2020-11-07 00:00:00+00:00,-29.73,28912.54,2020-11,transfer
2020-11-06 00:00:00+00:00,-28.5,28941.04,2020-11,bills and utilities
2020-11-06 00:00:00+00:00,25.77,28915.27,2020-11,taxes
2020-11-06 00:00:00+00:00,-1.35,28916.62,2020-11,groceries / food spend
2020-11-06 00:00:00+00:00,-50.59,28967.21,2020-11,bills and utilities
2020-11-06 00:00:00+00:00,-9.71,28976.92,2020-11,home and garden
2020-11-06 00:00:00+00:00,346.35,28630.57,2020-11,taxes
2020-11-06 00:00:00+00:00,87.66,28542.91,2020-11,transfer
2020-11-06 00:00:00+00:00,43.1,28499.81,2020-11,transfer
2020-11-06 00:00:00+00:00,-0.01,28499.82,2020-11,savings
2020-11-06 00:00:00+00:00,-1.42,28501.24,2020-11,shopping
2020-11-05 00:00:00+00:00,-60.0,28561.24,2020-11,transfer
2020-11-05 00:00:00+00:00,-1.89,28563.13,2020-11,savings
2020-11-05 00:00:00+00:00,-5.29,28568.42,2020-11,finances
2020-11-05 00:00:00+00:00,-3.74,28572.16,2020-11,shopping
2020-11-05 00:00:00+00:00,-23.15,28595.31,2020-11,transfer
2020-11-05 00:00:00+00:00,-12.85,28608.16,2020-11,finances
2020-11-05 00:00:00+00:00,-16.86,28625.02,2020-11,groceries / food spend
2020-11-05 00:00:00+00:00,-20.0,28645.02,2020-11,shopping
2020-11-04 00:00:00+00:00,10.0,28635.02,2020-11,transfer
2020-11-04 00:00:00+00:00,17.9,28617.12,2020-11,transfer
2020-11-04 00:00:00+00:00,64.64,28552.48,2020-11,transfer
2020-11-04 00:00:00+00:00,-12.5,28564.98,2020-11,transfer
2020-11-04 00:00:00+00:00,-5.0,28569.98,2020-11,shopping
2020-11-04 00:00:00+00:00,-2.51,28572.49,2020-11,finances
2020-11-04 00:00:00+00:00,-100.0,28672.49,2020-11,transfer
2020-11-04 00:00:00+00:00,100.0,28572.49,2020-11,transfer
2020-11-04 00:00:00+00:00,-3.59,28576.08,2020-11,business services
2020-11-04 00:00:00+00:00,33.05,28543.03,2020-11,transfer
2020-11-04 00:00:00+00:00,-130.0,28673.03,2020-11,rent
2020-11-03 00:00:00+00:00,0.64,28672.39,2020-11,transfer
2020-11-03 00:00:00+00:00,-0.43,28672.82,2020-11,savings
2020-11-03 00:00:00+00:00,5.69,28667.13,2020-11,transfer
2020-11-03 00:00:00+00:00,5.83,28661.3,2020-11,transfer
2020-11-03 00:00:00+00:00,-31.2,28692.5,2020-11,transport
2020-11-03 00:00:00+00:00,35.49,28657.01,2020-11,entertainment
2020-11-03 00:00:00+00:00,-0.01,28657.02,2020-11,savings
2020-11-03 00:00:00+00:00,-0.56,28657.58,2020-11,entertainment
2020-11-03 00:00:00+00:00,-30.0,28687.58,2020-11,shopping
2020-11-03 00:00:00+00:00,40.0,28647.58,2020-11,transfer
2020-11-03 00:00:00+00:00,-37.81,28685.39,2020-11,transfer
2020-11-03 00:00:00+00:00,-5.0,28690.39,2020-11,groceries / food spend
2020-11-02 00:00:00+00:00,34.23,28656.16,2020-11,transfer
2020-11-02 00:00:00+00:00,-30.0,28686.16,2020-11,transfer
2020-11-02 00:00:00+00:00,11.08,28675.08,2020-11,transfer
2020-11-02 00:00:00+00:00,-0.66,28675.74,2020-11,savings
2020-11-01 00:00:00+00:00,-46.82,28722.56,2020-11,bills and utilities
2020-11-01 00:00:00+00:00,-0.01,28722.57,2020-11,fees and charges
2020-11-01 00:00:00+00:00,-183.49,28906.06,2020-11,transfer
2020-11-01 00:00:00+00:00,-39.99,28946.05,2020-11,groceries / food spend
2020-11-01 00:00:00+00:00,-0.01,28946.06,2020-11,finances
2020-11-01 00:00:00+00:00,-0.01,28946.07,2020-11,shopping
2020-11-01 00:00:00+00:00,-0.01,28946.08,2020-11,shopping
2020-11-01 00:00:00+00:00,-0.01,28946.09,2020-11,groceries / food spend
2020-11-01 00:00:00+00:00,-0.01,28946.1,2020-11,groceries / food spend
2020-11-01 00:00:00+00:00,-0.01,28946.11,2020-11,groceries / food spend
2020-11-01 00:00:00+00:00,-0.01,28946.12,2020-11,groceries / food spend
2020-11-01 00:00:00+00:00,-0.01,28946.13,2020-11,transport
2020-11-01 00:00:00+00:00,-337.95,29284.08,2020-11,restaurants / eating out / delivery
2020-11-01 00:00:00+00:00,-0.01,29284.09,2020-11,home and garden
2020-11-01 00:00:00+00:00,-0.01,29284.1,2020-11,fees and charges
2020-11-01 00:00:00+00:00,-0.01,29284.11,2020-11,transport
2020-11-01 00:00:00+00:00,-0.01,29284.12,2020-11,entertainment
2020-11-01 00:00:00+00:00,-0.01,29284.13,2020-11,fees and charges
2020-11-01 00:00:00+00:00,6.22,29277.91,2020-11,groceries / food spend
2020-11-01 00:00:00+00:00,-8.27,29286.18,2020-11,transfer
2020-11-01 00:00:00+00:00,-13.09,29299.27,2020-11,business services
2020-11-01 00:00:00+00:00,-10.0,29309.27,2020-11,bills and utilities
2020-11-01 00:00:00+00:00,-10.0,29319.27,2020-11,finances
2020-11-01 00:00:00+00:00,-10.0,29329.27,2020-11,finances
2020-11-01 00:00:00+00:00,-10.23,29339.5,2020-11,bills and utilities
2020-10-28 00:00:00+00:00,420.0,28919.5,2020-10,transfer
2020-10-28 00:00:00+00:00,-36.59,28956.09,2020-10,shopping
2020-10-28 00:00:00+00:00,40.0,28916.09,2020-10,transfer
2020-10-28 00:00:00+00:00,-32.72,28948.81,2020-10,transfer
2020-10-28 00:00:00+00:00,22.42,28926.39,2020-10,taxes
2020-10-27 00:00:00+00:00,-7.93,28934.32,2020-10,transfer
2020-10-27 00:00:00+00:00,50.59,28883.73,2020-10,transfer
2020-10-27 00:00:00+00:00,15.86,28867.87,2020-10,transfer
2020-10-27 00:00:00+00:00,-22.94,28890.81,2020-10,transport
2020-10-27 00:00:00+00:00,-2.99,28893.8,2020-10,finances
2020-10-27 00:00:00+00:00,-31.32,28925.12,2020-10,groceries / food spend
2020-10-27 00:00:00+00:00,-7.56,28932.68,2020-10,shopping
2020-10-25 00:00:00+00:00,60.72,28871.96,2020-10,transfer
2020-10-25 00:00:00+00:00,9.18,28862.78,2020-10,entertainment
2020-10-25 00:00:00+00:00,-10.0,28872.78,2020-10,transfer
2020-10-25 00:00:00+00:00,-0.41,28873.19,2020-10,savings
2020-10-25 00:00:00+00:00,-45.84,28919.03,2020-10,shopping
2020-10-25 00:00:00+00:00,-0.5,28919.53,2020-10,savings
2020-10-25 00:00:00+00:00,-10.5,28930.03,2020-10,entertainment
2020-10-23 00:00:00+00:00,-30.0,28960.03,2020-10,finances
2020-10-23 00:00:00+00:00,33.15,28926.88,2020-10,transfer
2020-10-23 00:00:00+00:00,-100.0,29026.88,2020-10,transfer
2020-10-23 00:00:00+00:00,-1.85,29028.73,2020-10,savings
2020-10-23 00:00:00+00:00,-20.92,29049.65,2020-10,transfer
2020-10-22 00:00:00+00:00,-5.0,29054.65,2020-10,shopping
2020-10-22 00:00:00+00:00,-0.01,29054.66,2020-10,savings
2020-10-22 00:00:00+00:00,-39.25,29093.91,2020-10,bills and utilities
2020-10-22 00:00:00+00:00,-36.59,29130.5,2020-10,shopping
2020-10-22 00:00:00+00:00,-40.02,29170.52,2020-10,finances
2020-10-20 00:00:00+00:00,-150.0,29320.52,2020-10,rent
2020-10-20 00:00:00+00:00,21.57,29298.95,2020-10,taxes
2020-10-20 00:00:00+00:00,-550.0,29848.95,2020-10,business services
2020-10-20 00:00:00+00:00,345.13,29503.82,2020-10,taxes
2020-10-19 00:00:00+00:00,-12.9,29516.72,2020-10,shopping
2020-10-19 00:00:00+00:00,1450.42,28066.3,2020-10,salary
2020-10-18 00:00:00+00:00,82.21,27984.09,2020-10,finances
2020-10-17 00:00:00+00:00,137.6,27846.49,2020-10,transfer
2020-10-17 00:00:00+00:00,-12.73,27859.22,2020-10,finances
2020-10-17 00:00:00+00:00,-45.03,27904.25,2020-10,finances
2020-10-17 00:00:00+00:00,-20.0,27924.25,2020-10,transport
2020-10-17 00:00:00+00:00,-0.63,27924.88,2020-10,savings
2020-10-17 00:00:00+00:00,-10.79,27935.67,2020-10,groceries / food spend
2020-10-15 00:00:00+00:00,-32.0,27967.67,2020-10,groceries / food spend
2020-10-15 00:00:00+00:00,-0.58,27968.25,2020-10,savings
2020-10-15 00:00:00+00:00,7.97,27960.28,2020-10,shopping
2020-10-15 00:00:00+00:00,-0.5,27960.78,2020-10,savings
2020-10-15 00:00:00+00:00,-6.52,27967.3,2020-10,shopping
2020-10-15 00:00:00+00:00,-17.01,27984.31,2020-10,shopping
2020-10-14 00:00:00+00:00,-2.38,27986.69,2020-10,entertainment
2020-10-14 00:00:00+00:00,-20.5,28007.19,2020-10,entertainment
2020-10-14 00:00:00+00:00,66.94,27940.25,2020-10,entertainment
2020-10-12 00:00:00+00:00,-0.33,27940.58,2020-10,savings
2020-10-12 00:00:00+00:00,-23.11,27963.69,2020-10,transport
2020-10-11 00:00:00+00:00,50.0,27913.69,2020-10,finances
2020-10-11 00:00:00+00:00,50.0,27863.69,2020-10,transfer
2020-10-11 00:00:00+00:00,23.28,27840.41,2020-10,taxes
2020-10-11 00:00:00+00:00,-21.42,27861.83,2020-10,holidays
2020-10-10 00:00:00+00:00,-41.09,27902.92,2020-10,finances
2020-10-10 00:00:00+00:00,-5.0,27907.92,2020-10,groceries / food spend
2020-10-10 00:00:00+00:00,40.0,27867.92,2020-10,transfer
2020-10-10 00:00:00+00:00,50.36,27817.56,2020-10,finances
2020-10-10 00:00:00+00:00,-18.38,27835.94,2020-10,transfer
2020-10-10 00:00:00+00:00,-24.07,27860.01,2020-10,bills and utilities
2020-10-09 00:00:00+00:00,-28.25,27888.26,2020-10,transport
2020-10-09 00:00:00+00:00,-19.53,27907.79,2020-10,taxes
2020-10-09 00:00:00+00:00,-0.41,27908.2,2020-10,savings
2020-10-09 00:00:00+00:00,49.82,27858.38,2020-10,transfer
2020-10-08 00:00:00+00:00,-0.01,27858.39,2020-10,savings
2020-10-08 00:00:00+00:00,22.42,27835.97,2020-10,taxes
2020-10-08 00:00:00+00:00,-14.99,27850.96,2020-10,fees and charges
2020-10-08 00:00:00+00:00,-100.0,27950.96,2020-10,rent
2020-10-08 00:00:00+00:00,-3.62,27954.58,2020-10,entertainment
2020-10-08 00:00:00+00:00,-0.82,27955.4,2020-10,savings
2020-10-08 00:00:00+00:00,-1.04,27956.44,2020-10,savings
2020-10-08 00:00:00+00:00,-24.31,27980.75,2020-10,groceries / food spend
2020-10-07 00:00:00+00:00,-69.07,28049.82,2020-10,bills and utilities
2020-10-07 00:00:00+00:00,-1.15,28050.97,2020-10,savings
2020-10-07 00:00:00+00:00,-70.0,28120.97,2020-10,transfer
2020-10-06 00:00:00+00:00,-28.25,28149.22,2020-10,bills and utilities
2020-10-06 00:00:00+00:00,21.89,28127.33,2020-10,taxes
2020-10-06 00:00:00+00:00,-15.29,28142.62,2020-10,groceries / food spend
2020-10-06 00:00:00+00:00,-50.0,28192.62,2020-10,bills and utilities
2020-10-06 00:00:00+00:00,-9.71,28202.33,2020-10,home and garden
2020-10-06 00:00:00+00:00,357.06,27845.27,2020-10,taxes
2020-10-06 00:00:00+00:00,137.6,27707.67,2020-10,transfer
2020-10-06 00:00:00+00:00,61.89,27645.78,2020-10,transfer
2020-10-06 00:00:00+00:00,-0.01,27645.79,2020-10,savings
2020-10-06 00:00:00+00:00,-10.39,27656.18,2020-10,shopping
2020-10-05 00:00:00+00:00,-14.16,27670.34,2020-10,transfer
2020-10-05 00:00:00+00:00,-1.89,27672.23,2020-10,savings
2020-10-05 00:00:00+00:00,-3.53,27675.76,2020-10,finances
2020-10-05 00:00:00+00:00,-9.53,27685.29,2020-10,shopping
2020-10-05 00:00:00+00:00,-40.23,27725.52,2020-10,transfer
2020-10-05 00:00:00+00:00,-11.82,27737.34,2020-10,finances
2020-10-05 00:00:00+00:00,-6.37,27743.71,2020-10,groceries / food spend
2020-10-05 00:00:00+00:00,-20.0,27763.71,2020-10,shopping
2020-10-04 00:00:00+00:00,10.0,27753.71,2020-10,transfer
2020-10-04 00:00:00+00:00,70.0,27683.71,2020-10,transfer
2020-10-04 00:00:00+00:00,98.53,27585.18,2020-10,transfer
2020-10-04 00:00:00+00:00,-20.6,27605.78,2020-10,transfer
2020-10-04 00:00:00+00:00,-5.71,27611.49,2020-10,shopping
2020-10-04 00:00:00+00:00,-3.07,27614.56,2020-10,finances
2020-10-04 00:00:00+00:00,-79.05,27693.61,2020-10,transfer
2020-10-04 00:00:00+00:00,100.0,27593.61,2020-10,transfer
2020-10-04 00:00:00+00:00,-3.59,27597.2,2020-10,business services
2020-10-04 00:00:00+00:00,43.95,27553.25,2020-10,transfer
2020-10-04 00:00:00+00:00,-130.0,27683.25,2020-10,rent
2020-10-03 00:00:00+00:00,1.12,27682.13,2020-10,transfer
2020-10-03 00:00:00+00:00,-0.43,27682.56,2020-10,savings
2020-10-03 00:00:00+00:00,130.0,27552.56,2020-10,transfer
2020-10-03 00:00:00+00:00,7.0,27545.56,2020-10,transfer
2020-10-03 00:00:00+00:00,-23.11,27568.67,2020-10,transport
2020-10-03 00:00:00+00:00,43.26,27525.41,2020-10,entertainment
2020-10-03 00:00:00+00:00,-0.01,27525.42,2020-10,savings
2020-10-03 00:00:00+00:00,-4.02,27529.44,2020-10,entertainment
2020-10-03 00:00:00+00:00,-14.32,27543.76,2020-10,shopping
2020-10-03 00:00:00+00:00,40.0,27503.76,2020-10,transfer
2020-10-03 00:00:00+00:00,-40.0,27543.76,2020-10,transfer
2020-10-03 00:00:00+00:00,1.52,27542.24,2020-10,groceries / food spend
2020-10-02 00:00:00+00:00,30.0,27512.24,2020-10,transfer
2020-10-02 00:00:00+00:00,-18.85,27531.09,2020-10,transfer
2020-10-02 00:00:00+00:00,10.0,27521.09,2020-10,transfer
2020-10-02 00:00:00+00:00,-0.59,27521.68,2020-10,savings
2020-10-01 00:00:00+00:00,-54.81,27576.49,2020-10,bills and utilities
2020-10-01 00:00:00+00:00,-0.01,27576.5,2020-10,fees and charges
2020-10-01 00:00:00+00:00,-384.52,27961.02,2020-10,transfer
2020-10-01 00:00:00+00:00,-39.99,28001.01,2020-10,groceries / food spend
2020-10-01 00:00:00+00:00,-0.01,28001.02,2020-10,finances
2020-10-01 00:00:00+00:00,-0.01,28001.03,2020-10,shopping
2020-10-01 00:00:00+00:00,-0.01,28001.04,2020-10,shopping
2020-10-01 00:00:00+00:00,-0.01,28001.05,2020-10,groceries / food spend
2020-10-01 00:00:00+00:00,-0.01,28001.06,2020-10,groceries / food spend
2020-10-01 00:00:00+00:00,-0.01,28001.07,2020-10,groceries / food spend
2020-10-01 00:00:00+00:00,-0.02,28001.09,2020-10,groceries / food spend
2020-10-01 00:00:00+00:00,-0.01,28001.1,2020-10,transport
2020-10-01 00:00:00+00:00,-99.83,28100.93,2020-10,restaurants / eating out / delivery
2020-10-01 00:00:00+00:00,-0.01,28100.94,2020-10,home and garden
2020-10-01 00:00:00+00:00,-0.01,28100.95,2020-10,fees and charges
2020-10-01 00:00:00+00:00,-0.01,28100.96,2020-10,transport
2020-10-01 00:00:00+00:00,-0.01,28100.97,2020-10,entertainment
2020-10-01 00:00:00+00:00,-0.01,28100.98,2020-10,fees and charges
2020-10-01 00:00:00+00:00,-21.07,28122.05,2020-10,groceries / food spend
2020-10-01 00:00:00+00:00,-37.74,28159.79,2020-10,transfer
2020-10-01 00:00:00+00:00,-10.0,28169.79,2020-10,business services
2020-10-01 00:00:00+00:00,-10.87,28180.66,2020-10,bills and utilities
2020-10-01 00:00:00+00:00,-10.0,28190.66,2020-10,finances
2020-10-01 00:00:00+00:00,-10.0,28200.66,2020-10,finances
2020-10-01 00:00:00+00:00,-10.0,28210.66,2020-10,bills and utilities
2020-09-28 00:00:00+00:00,667.18,27543.48,2020-09,transfer
2020-09-28 00:00:00+00:00,-36.59,27580.07,2020-09,shopping
2020-09-28 00:00:00+00:00,40.0,27540.07,2020-09,transfer
2020-09-28 00:00:00+00:00,-32.72,27572.79,2020-09,transfer
2020-09-28 00:00:00+00:00,22.42,27550.37,2020-09,taxes
2020-09-27 00:00:00+00:00,-6.17,27556.54,2020-09,transfer
2020-09-27 00:00:00+00:00,47.02,27509.52,2020-09,transfer
2020-09-27 00:00:00+00:00,22.73,27486.79,2020-09,transfer
2020-09-27 00:00:00+00:00,-20.56,27507.35,2020-09,transport
2020-09-27 00:00:00+00:00,-1.82,27509.17,2020-09,finances
2020-09-27 00:00:00+00:00,-22.24,27531.41,2020-09,groceries / food spend
2020-09-27 00:00:00+00:00,-5.74,27537.15,2020-09,shopping
2020-09-25 00:00:00+00:00,70.0,27467.15,2020-09,transfer
2020-09-25 00:00:00+00:00,-24.5,27491.65,2020-09,entertainment
2020-09-25 00:00:00+00:00,-10.0,27501.65,2020-09,transfer
2020-09-25 00:00:00+00:00,-0.41,27502.06,2020-09,savings
2020-09-25 00:00:00+00:00,-5.02,27507.08,2020-09,shopping
2020-09-25 00:00:00+00:00,-0.57,27507.65,2020-09,savings
2020-09-25 00:00:00+00:00,-9.38,27517.03,2020-09,entertainment
2020-09-23 00:00:00+00:00,-30.0,27547.03,2020-09,finances
2020-09-23 00:00:00+00:00,32.5,27514.53,2020-09,transfer
2020-09-23 00:00:00+00:00,-100.0,27614.53,2020-09,transfer
2020-09-23 00:00:00+00:00,-1.57,27616.1,2020-09,savings
2020-09-23 00:00:00+00:00,-23.41,27639.51,2020-09,transfer
2020-09-22 00:00:00+00:00,-5.0,27644.51,2020-09,shopping
2020-09-22 00:00:00+00:00,-0.01,27644.52,2020-09,savings
2020-09-22 00:00:00+00:00,-39.25,27683.77,2020-09,bills and utilities
2020-09-22 00:00:00+00:00,-36.59,27720.36,2020-09,shopping
2020-09-22 00:00:00+00:00,-33.5,27753.86,2020-09,finances
2020-09-20 00:00:00+00:00,-150.0,27903.86,2020-09,rent
2020-09-20 00:00:00+00:00,21.33,27882.53,2020-09,taxes
2020-09-20 00:00:00+00:00,-550.0,28432.53,2020-09,business services
2020-09-20 00:00:00+00:00,345.13,28087.4,2020-09,taxes
2020-09-19 00:00:00+00:00,-7.99,28095.39,2020-09,shopping
2020-09-19 00:00:00+00:00,1450.42,26644.97,2020-09,salary
2020-09-18 00:00:00+00:00,82.21,26562.76,2020-09,finances
2020-09-17 00:00:00+00:00,143.62,26419.14,2020-09,transfer
2020-09-17 00:00:00+00:00,-12.73,26431.87,2020-09,finances
2020-09-17 00:00:00+00:00,-33.18,26465.05,2020-09,finances
2020-09-17 00:00:00+00:00,-20.0,26485.05,2020-09,transport
2020-09-17 00:00:00+00:00,-0.63,26485.68,2020-09,savings
2020-09-17 00:00:00+00:00,-12.57,26498.25,2020-09,groceries / food spend
2020-09-15 00:00:00+00:00,-32.0,26530.25,2020-09,groceries / food spend
2020-09-15 00:00:00+00:00,-0.53,26530.78,2020-09,savings
2020-09-15 00:00:00+00:00,-33.53,26564.31,2020-09,shopping
2020-09-15 00:00:00+00:00,-0.5,26564.81,2020-09,savings
2020-09-15 00:00:00+00:00,-2.55,26567.36,2020-09,shopping
2020-09-15 00:00:00+00:00,-12.59,26579.95,2020-09,shopping
2020-09-14 00:00:00+00:00,-2.0,26581.95,2020-09,entertainment
2020-09-14 00:00:00+00:00,-20.5,26602.45,2020-09,entertainment
2020-09-14 00:00:00+00:00,6.55,26595.9,2020-09,entertainment
2020-09-12 00:00:00+00:00,-0.42,26596.32,2020-09,savings
2020-09-12 00:00:00+00:00,-22.93,26619.25,2020-09,transport
2020-09-11 00:00:00+00:00,57.94,26561.31,2020-09,finances
2020-09-11 00:00:00+00:00,79.65,26481.66,2020-09,transfer
2020-09-11 00:00:00+00:00,23.66,26458.0,2020-09,taxes
2020-09-11 00:00:00+00:00,-17.0,26475.0,2020-09,holidays
2020-09-10 00:00:00+00:00,-24.58,26499.58,2020-09,finances
2020-09-10 00:00:00+00:00,-1.81,26501.39,2020-09,groceries / food spend
2020-09-10 00:00:00+00:00,37.46,26463.93,2020-09,transfer
2020-09-10 00:00:00+00:00,56.93,26407.0,2020-09,finances
2020-09-10 00:00:00+00:00,-30.0,26437.0,2020-09,transfer
2020-09-10 00:00:00+00:00,-24.5,26461.5,2020-09,bills and utilities
2020-09-09 00:00:00+00:00,-23.62,26485.12,2020-09,transport
2020-09-09 00:00:00+00:00,-18.89,26504.01,2020-09,taxes
2020-09-09 00:00:00+00:00,-0.41,26504.42,2020-09,savings
2020-09-09 00:00:00+00:00,70.0,26434.42,2020-09,transfer
2020-09-08 00:00:00+00:00,-0.01,26434.43,2020-09,savings
2020-09-08 00:00:00+00:00,22.42,26412.01,2020-09,taxes
2020-09-08 00:00:00+00:00,-9.55,26421.56,2020-09,fees and charges
2020-09-08 00:00:00+00:00,-100.0,26521.56,2020-09,rent
2020-09-08 00:00:00+00:00,-1.24,26522.8,2020-09,entertainment
2020-09-08 00:00:00+00:00,-0.69,26523.49,2020-09,savings
2020-09-08 00:00:00+00:00,-1.32,26524.81,2020-09,savings
2020-09-08 00:00:00+00:00,1.83,26522.98,2020-09,groceries / food spend
2020-09-07 00:00:00+00:00,-82.37,26605.35,2020-09,bills and utilities
2020-09-07 00:00:00+00:00,-1.16,26606.51,2020-09,savings
2020-09-07 00:00:00+00:00,-70.0,26676.51,2020-09,transfer
2020-09-06 00:00:00+00:00,-28.25,26704.76,2020-09,bills and utilities
2020-09-06 00:00:00+00:00,22.42,26682.34,2020-09,taxes
2020-09-06 00:00:00+00:00,-12.89,26695.23,2020-09,groceries / food spend
2020-09-06 00:00:00+00:00,-50.0,26745.23,2020-09,bills and utilities
2020-09-06 00:00:00+00:00,-1.09,26746.32,2020-09,home and garden
2020-09-06 00:00:00+00:00,346.35,26399.97,2020-09,taxes
2020-09-06 00:00:00+00:00,93.78,26306.19,2020-09,transfer
2020-09-06 00:00:00+00:00,61.89,26244.3,2020-09,transfer
2020-09-06 00:00:00+00:00,-0.01,26244.31,2020-09,savings
2020-09-06 00:00:00+00:00,-5.0,26249.31,2020-09,shopping
2020-09-05 00:00:00+00:00,-76.35,26325.66,2020-09,transfer
2020-09-05 00:00:00+00:00,-1.89,26327.55,2020-09,savings
2020-09-05 00:00:00+00:00,-5.79,26333.34,2020-09,finances
2020-09-05 00:00:00+00:00,-12.66,26346.0,2020-09,shopping
2020-09-05 00:00:00+00:00,-32.97,26378.97,2020-09,transfer
2020-09-05 00:00:00+00:00,-12.73,26391.7,2020-09,finances
2020-09-05 00:00:00+00:00,-6.48,26398.18,2020-09,groceries / food spend
2020-09-05 00:00:00+00:00,-15.87,26414.05,2020-09,shopping
2020-09-04 00:00:00+00:00,10.0,26404.05,2020-09,transfer
2020-09-04 00:00:00+00:00,30.91,26373.14,2020-09,transfer
2020-09-04 00:00:00+00:00,59.27,26313.87,2020-09,transfer
2020-09-04 00:00:00+00:00,-20.0,26333.87,2020-09,transfer
2020-09-04 00:00:00+00:00,-5.0,26338.87,2020-09,shopping
2020-09-04 00:00:00+00:00,-3.07,26341.94,2020-09,finances
2020-09-04 00:00:00+00:00,-113.6,26455.54,2020-09,transfer
2020-09-04 00:00:00+00:00,129.29,26326.25,2020-09,transfer
2020-09-04 00:00:00+00:00,-3.59,26329.84,2020-09,business services
2020-09-04 00:00:00+00:00,45.69,26284.15,2020-09,transfer
2020-09-04 00:00:00+00:00,-130.0,26414.15,2020-09,rent
2020-09-03 00:00:00+00:00,0.89,26413.26,2020-09,transfer
2020-09-03 00:00:00+00:00,-0.41,26413.67,2020-09,savings
2020-09-03 00:00:00+00:00,104.71,26308.96,2020-09,transfer
2020-09-03 00:00:00+00:00,8.6,26300.36,2020-09,transfer
2020-09-03 00:00:00+00:00,-23.11,26323.47,2020-09,transport
2020-09-03 00:00:00+00:00,35.49,26287.98,2020-09,entertainment
2020-09-03 00:00:00+00:00,-0.01,26287.99,2020-09,savings
2020-09-03 00:00:00+00:00,-3.77,26291.76,2020-09,entertainment
2020-09-03 00:00:00+00:00,-30.0,26321.76,2020-09,shopping
2020-09-03 00:00:00+00:00,38.67,26283.09,2020-09,transfer
2020-09-03 00:00:00+00:00,-37.44,26320.53,2020-09,transfer
2020-09-03 00:00:00+00:00,-5.0,26325.53,2020-09,groceries / food spend
2020-09-02 00:00:00+00:00,25.29,26300.24,2020-09,transfer
2020-09-02 00:00:00+00:00,-30.0,26330.24,2020-09,transfer
2020-09-02 00:00:00+00:00,10.0,26320.24,2020-09,transfer
2020-09-02 00:00:00+00:00,-0.59,26320.83,2020-09,savings
2020-09-01 00:00:00+00:00,-46.82,26367.65,2020-09,bills and utilities
2020-09-01 00:00:00+00:00,-0.01,26367.66,2020-09,fees and charges
2020-09-01 00:00:00+00:00,-227.0,26594.66,2020-09,transfer
2020-09-01 00:00:00+00:00,17.38,26577.28,2020-09,groceries / food spend
2020-09-01 00:00:00+00:00,-0.01,26577.29,2020-09,finances
2020-09-01 00:00:00+00:00,-0.01,26577.3,2020-09,shopping
2020-09-01 00:00:00+00:00,-0.01,26577.31,2020-09,shopping
2020-09-01 00:00:00+00:00,-0.01,26577.32,2020-09,groceries / food spend
2020-09-01 00:00:00+00:00,-0.01,26577.33,2020-09,groceries / food spend
2020-09-01 00:00:00+00:00,0.0,26577.33,2020-09,groceries / food spend
2020-09-01 00:00:00+00:00,-0.03,26577.36,2020-09,groceries / food spend
2020-09-01 00:00:00+00:00,-0.0,26577.36,2020-09,transport
2020-09-01 00:00:00+00:00,-342.14,26919.5,2020-09,restaurants / eating out / delivery
2020-09-01 00:00:00+00:00,-0.01,26919.51,2020-09,home and garden
2020-09-01 00:00:00+00:00,-0.02,26919.53,2020-09,fees and charges
2020-09-01 00:00:00+00:00,-0.01,26919.54,2020-09,transport
2020-09-01 00:00:00+00:00,-0.01,26919.55,2020-09,entertainment
2020-09-01 00:00:00+00:00,-0.0,26919.55,2020-09,fees and charges
2020-09-01 00:00:00+00:00,-30.34,26949.89,2020-09,groceries / food spend
2020-09-01 00:00:00+00:00,-20.91,26970.8,2020-09,transfer
2020-09-01 00:00:00+00:00,-10.0,26980.8,2020-09,business services
2020-09-01 00:00:00+00:00,-10.87,26991.67,2020-09,bills and utilities
2020-09-01 00:00:00+00:00,-10.0,27001.67,2020-09,finances
2020-09-01 00:00:00+00:00,-6.86,27008.53,2020-09,finances
2020-09-01 00:00:00+00:00,-9.95,27018.48,2020-09,bills and utilities
2020-08-28 00:00:00+00:00,420.0,26598.48,2020-08,transfer
2020-08-28 00:00:00+00:00,-31.97,26630.45,2020-08,shopping
2020-08-28 00:00:00+00:00,68.1,26562.35,2020-08,transfer
2020-08-28 00:00:00+00:00,-32.72,26595.07,2020-08,transfer
2020-08-28 00:00:00+00:00,24.22,26570.85,2020-08,taxes
2020-08-27 00:00:00+00:00,-7.93,26578.78,2020-08,transfer
2020-08-27 00:00:00+00:00,50.59,26528.19,2020-08,transfer
2020-08-27 00:00:00+00:00,15.86,26512.33,2020-08,transfer
2020-08-27 00:00:00+00:00,-20.56,26532.89,2020-08,transport
2020-08-27 00:00:00+00:00,-3.72,26536.61,2020-08,finances
2020-08-27 00:00:00+00:00,-63.55,26600.16,2020-08,groceries / food spend
2020-08-27 00:00:00+00:00,13.84,26586.32,2020-08,shopping
2020-08-25 00:00:00+00:00,70.0,26516.32,2020-08,transfer
2020-08-25 00:00:00+00:00,-14.92,26531.24,2020-08,entertainment
2020-08-25 00:00:00+00:00,-9.42,26540.66,2020-08,transfer
2020-08-25 00:00:00+00:00,-0.3,26540.96,2020-08,savings
2020-08-25 00:00:00+00:00,-44.38,26585.34,2020-08,shopping
2020-08-25 00:00:00+00:00,-0.5,26585.84,2020-08,savings
2020-08-25 00:00:00+00:00,0.49,26585.35,2020-08,entertainment
2020-08-23 00:00:00+00:00,-38.11,26623.46,2020-08,finances
2020-08-23 00:00:00+00:00,32.5,26590.96,2020-08,transfer
2020-08-23 00:00:00+00:00,-113.94,26704.9,2020-08,transfer
2020-08-23 00:00:00+00:00,-1.54,26706.44,2020-08,savings
2020-08-23 00:00:00+00:00,-26.99,26733.43,2020-08,transfer
2020-08-22 00:00:00+00:00,-5.0,26738.43,2020-08,shopping
2020-08-22 00:00:00+00:00,-0.01,26738.44,2020-08,savings
2020-08-22 00:00:00+00:00,-34.86,26773.3,2020-08,bills and utilities
2020-08-22 00:00:00+00:00,-36.59,26809.89,2020-08,shopping
2020-08-22 00:00:00+00:00,-36.59,26846.48,2020-08,finances
2020-08-20 00:00:00+00:00,-150.0,26996.48,2020-08,rent
2020-08-20 00:00:00+00:00,21.24,26975.24,2020-08,taxes
2020-08-20 00:00:00+00:00,-304.28,27279.52,2020-08,business services
2020-08-20 00:00:00+00:00,345.13,26934.39,2020-08,taxes
2020-08-19 00:00:00+00:00,-7.99,26942.38,2020-08,shopping
2020-08-19 00:00:00+00:00,1450.42,25491.96,2020-08,salary
2020-08-18 00:00:00+00:00,82.21,25409.75,2020-08,finances
2020-08-17 00:00:00+00:00,137.6,25272.15,2020-08,transfer
2020-08-17 00:00:00+00:00,-14.81,25286.96,2020-08,finances
2020-08-17 00:00:00+00:00,-43.59,25330.55,2020-08,finances
2020-08-17 00:00:00+00:00,-33.34,25363.89,2020-08,transport
2020-08-17 00:00:00+00:00,-0.71,25364.6,2020-08,savings
2020-08-17 00:00:00+00:00,-0.93,25365.53,2020-08,groceries / food spend
2020-08-15 00:00:00+00:00,-90.34,25455.87,2020-08,groceries / food spend
2020-08-15 00:00:00+00:00,-0.55,25456.42,2020-08,savings
2020-08-15 00:00:00+00:00,-11.59,25468.01,2020-08,shopping
2020-08-15 00:00:00+00:00,-0.45,25468.46,2020-08,savings
2020-08-15 00:00:00+00:00,-3.59,25472.05,2020-08,shopping
2020-08-15 00:00:00+00:00,-12.27,25484.32,2020-08,shopping
2020-08-14 00:00:00+00:00,-2.0,25486.32,2020-08,entertainment
2020-08-14 00:00:00+00:00,-20.5,25506.82,2020-08,entertainment
2020-08-14 00:00:00+00:00,43.5,25463.32,2020-08,entertainment
2020-08-12 00:00:00+00:00,-0.4,25463.72,2020-08,savings
2020-08-12 00:00:00+00:00,-23.11,25486.83,2020-08,transport
2020-08-11 00:00:00+00:00,50.0,25436.83,2020-08,finances
2020-08-11 00:00:00+00:00,39.06,25397.77,2020-08,transfer
2020-08-11 00:00:00+00:00,22.85,25374.92,2020-08,taxes
2020-08-11 00:00:00+00:00,-23.27,25398.19,2020-08,holidays
2020-08-10 00:00:00+00:00,-40.0,25438.19,2020-08,finances
2020-08-10 00:00:00+00:00,-5.0,25443.19,2020-08,groceries / food spend
2020-08-10 00:00:00+00:00,40.0,25403.19,2020-08,transfer
2020-08-10 00:00:00+00:00,46.34,25356.85,2020-08,finances
2020-08-10 00:00:00+00:00,-32.12,25388.97,2020-08,transfer
2020-08-10 00:00:00+00:00,-30.86,25419.83,2020-08,bills and utilities
2020-08-09 00:00:00+00:00,-23.62,25443.45,2020-08,transport
2020-08-09 00:00:00+00:00,-20.55,25464.0,2020-08,taxes
2020-08-09 00:00:00+00:00,-0.41,25464.41,2020-08,savings
2020-08-09 00:00:00+00:00,93.46,25370.95,2020-08,transfer
2020-08-08 00:00:00+00:00,-0.01,25370.96,2020-08,savings
2020-08-08 00:00:00+00:00,22.42,25348.54,2020-08,taxes
2020-08-08 00:00:00+00:00,5.11,25343.43,2020-08,fees and charges
2020-08-08 00:00:00+00:00,-100.0,25443.43,2020-08,rent
2020-08-08 00:00:00+00:00,-9.34,25452.77,2020-08,entertainment
2020-08-08 00:00:00+00:00,-0.69,25453.46,2020-08,savings
2020-08-08 00:00:00+00:00,-1.26,25454.72,2020-08,savings
2020-08-08 00:00:00+00:00,-24.31,25479.03,2020-08,groceries / food spend
2020-08-07 00:00:00+00:00,-82.37,25561.4,2020-08,bills and utilities
2020-08-07 00:00:00+00:00,-1.15,25562.55,2020-08,savings
2020-08-07 00:00:00+00:00,-21.88,25584.43,2020-08,transfer
2020-08-06 00:00:00+00:00,-27.09,25611.52,2020-08,bills and utilities
2020-08-06 00:00:00+00:00,22.42,25589.1,2020-08,taxes
2020-08-06 00:00:00+00:00,-12.89,25601.99,2020-08,groceries / food spend
2020-08-06 00:00:00+00:00,-50.0,25651.99,2020-08,bills and utilities
2020-08-06 00:00:00+00:00,-25.47,25677.46,2020-08,home and garden
2020-08-06 00:00:00+00:00,346.35,25331.11,2020-08,taxes
2020-08-06 00:00:00+00:00,-51.56,25382.67,2020-08,transfer
2020-08-06 00:00:00+00:00,59.88,25322.79,2020-08,transfer
2020-08-06 00:00:00+00:00,-0.01,25322.8,2020-08,savings
2020-08-06 00:00:00+00:00,-5.0,25327.8,2020-08,shopping
2020-08-05 00:00:00+00:00,-81.51,25409.31,2020-08,transfer
2020-08-05 00:00:00+00:00,-1.8,25411.11,2020-08,savings
2020-08-05 00:00:00+00:00,-5.79,25416.9,2020-08,finances
2020-08-05 00:00:00+00:00,3.4,25413.5,2020-08,shopping
2020-08-05 00:00:00+00:00,-23.15,25436.65,2020-08,transfer
2020-08-05 00:00:00+00:00,-12.73,25449.38,2020-08,finances
2020-08-05 00:00:00+00:00,-0.54,25449.92,2020-08,groceries / food spend
2020-08-05 00:00:00+00:00,-20.0,25469.92,2020-08,shopping
2020-08-04 00:00:00+00:00,4.66,25465.26,2020-08,transfer
2020-08-04 00:00:00+00:00,47.53,25417.73,2020-08,transfer
2020-08-04 00:00:00+00:00,69.88,25347.85,2020-08,transfer
2020-08-04 00:00:00+00:00,-20.0,25367.85,2020-08,transfer
2020-08-04 00:00:00+00:00,-0.32,25368.17,2020-08,shopping
2020-08-04 00:00:00+00:00,-3.07,25371.24,2020-08,finances
2020-08-04 00:00:00+00:00,-54.64,25425.88,2020-08,transfer
2020-08-04 00:00:00+00:00,100.0,25325.88,2020-08,transfer
2020-08-04 00:00:00+00:00,-3.59,25329.47,2020-08,business services
2020-08-04 00:00:00+00:00,18.86,25310.61,2020-08,transfer
2020-08-04 00:00:00+00:00,-130.0,25440.61,2020-08,rent
2020-08-03 00:00:00+00:00,0.66,25439.95,2020-08,transfer
2020-08-03 00:00:00+00:00,-0.41,25440.36,2020-08,savings
2020-08-03 00:00:00+00:00,130.0,25310.36,2020-08,transfer
2020-08-03 00:00:00+00:00,7.0,25303.36,2020-08,transfer
2020-08-03 00:00:00+00:00,-23.11,25326.47,2020-08,transport
2020-08-03 00:00:00+00:00,35.49,25290.98,2020-08,entertainment
2020-08-03 00:00:00+00:00,-0.01,25290.99,2020-08,savings
2020-08-03 00:00:00+00:00,-5.01,25296.0,2020-08,entertainment
2020-08-03 00:00:00+00:00,-30.0,25326.0,2020-08,shopping
2020-08-03 00:00:00+00:00,21.17,25304.83,2020-08,transfer
2020-08-03 00:00:00+00:00,-57.25,25362.08,2020-08,transfer
2020-08-03 00:00:00+00:00,-7.85,25369.93,2020-08,groceries / food spend
2020-08-02 00:00:00+00:00,37.3,25332.63,2020-08,transfer
2020-08-02 00:00:00+00:00,-28.62,25361.25,2020-08,transfer
2020-08-02 00:00:00+00:00,10.0,25351.25,2020-08,transfer
2020-08-02 00:00:00+00:00,-0.57,25351.82,2020-08,savings
2020-08-01 00:00:00+00:00,-46.82,25398.64,2020-08,bills and utilities
2020-08-01 00:00:00+00:00,-0.01,25398.65,2020-08,fees and charges
2020-08-01 00:00:00+00:00,-227.0,25625.65,2020-08,transfer
2020-08-01 00:00:00+00:00,-39.99,25665.64,2020-08,groceries / food spend
2020-08-01 00:00:00+00:00,-0.01,25665.65,2020-08,finances
2020-08-01 00:00:00+00:00,-0.01,25665.66,2020-08,shopping
2020-08-01 00:00:00+00:00,-0.01,25665.67,2020-08,shopping
2020-08-01 00:00:00+00:00,-0.01,25665.68,2020-08,groceries / food spend
2020-08-01 00:00:00+00:00,-0.01,25665.69,2020-08,groceries / food spend
2020-08-01 00:00:00+00:00,-0.01,25665.7,2020-08,groceries / food spend
2020-08-01 00:00:00+00:00,-0.01,25665.71,2020-08,groceries / food spend
2020-08-01 00:00:00+00:00,-0.01,25665.72,2020-08,transport
2020-08-01 00:00:00+00:00,-200.0,25865.72,2020-08,restaurants / eating out / delivery
2020-08-01 00:00:00+00:00,-0.0,25865.72,2020-08,home and garden
2020-08-01 00:00:00+00:00,-0.01,25865.73,2020-08,fees and charges
2020-08-01 00:00:00+00:00,-0.01,25865.74,2020-08,transport
2020-08-01 00:00:00+00:00,-0.01,25865.75,2020-08,entertainment
2020-08-01 00:00:00+00:00,-0.01,25865.76,2020-08,fees and charges
2020-08-01 00:00:00+00:00,-7.13,25872.89,2020-08,groceries / food spend
2020-08-01 00:00:00+00:00,-6.53,25879.42,2020-08,transfer
2020-08-01 00:00:00+00:00,-10.0,25889.42,2020-08,business services
2020-08-01 00:00:00+00:00,-12.03,25901.45,2020-08,bills and utilities
2020-08-01 00:00:00+00:00,-10.0,25911.45,2020-08,finances
2020-08-01 00:00:00+00:00,-10.0,25921.45,2020-08,finances
2020-08-01 00:00:00+00:00,-10.0,25931.45,2020-08,bills and utilities
2020-07-28 00:00:00+00:00,420.0,25511.45,2020-07,transfer
2020-07-28 00:00:00+00:00,-2.44,25513.89,2020-07,shopping
2020-07-28 00:00:00+00:00,54.87,25459.02,2020-07,transfer
2020-07-28 00:00:00+00:00,-12.23,25471.25,2020-07,transfer
2020-07-28 00:00:00+00:00,22.18,25449.07,2020-07,taxes
2020-07-27 00:00:00+00:00,-5.04,25454.11,2020-07,transfer
2020-07-27 00:00:00+00:00,7.43,25446.68,2020-07,transfer
2020-07-27 00:00:00+00:00,15.86,25430.82,2020-07,transfer
2020-07-27 00:00:00+00:00,-20.51,25451.33,2020-07,transport
2020-07-27 00:00:00+00:00,-2.16,25453.49,2020-07,finances
2020-07-27 00:00:00+00:00,-16.79,25470.28,2020-07,groceries / food spend
2020-07-27 00:00:00+00:00,-7.56,25477.84,2020-07,shopping
2020-07-25 00:00:00+00:00,70.0,25407.84,2020-07,transfer
2020-07-25 00:00:00+00:00,-1.14,25408.98,2020-07,entertainment
2020-07-25 00:00:00+00:00,-10.0,25418.98,2020-07,transfer
2020-07-25 00:00:00+00:00,-0.38,25419.36,2020-07,savings
2020-07-25 00:00:00+00:00,-36.59,25455.95,2020-07,shopping
2020-07-25 00:00:00+00:00,-0.46,25456.41,2020-07,savings
2020-07-25 00:00:00+00:00,-9.68,25466.09,2020-07,entertainment
2020-07-23 00:00:00+00:00,-30.0,25496.09,2020-07,finances
2020-07-23 00:00:00+00:00,32.5,25463.59,2020-07,transfer
2020-07-23 00:00:00+00:00,-100.0,25563.59,2020-07,transfer
2020-07-23 00:00:00+00:00,-1.57,25565.16,2020-07,savings
2020-07-23 00:00:00+00:00,-20.0,25585.16,2020-07,transfer
2020-07-22 00:00:00+00:00,-9.12,25594.28,2020-07,shopping
2020-07-22 00:00:00+00:00,-0.01,25594.29,2020-07,savings
2020-07-22 00:00:00+00:00,-35.23,25629.52,2020-07,bills and utilities
2020-07-22 00:00:00+00:00,-46.18,25675.7,2020-07,shopping
2020-07-22 00:00:00+00:00,-41.83,25717.53,2020-07,finances
2020-07-20 00:00:00+00:00,-150.0,25867.53,2020-07,rent
2020-07-20 00:00:00+00:00,22.42,25845.11,2020-07,taxes
2020-07-20 00:00:00+00:00,-534.59,26379.7,2020-07,business services
2020-07-20 00:00:00+00:00,351.96,26027.74,2020-07,taxes
2020-07-19 00:00:00+00:00,-7.99,26035.73,2020-07,shopping
2020-07-19 00:00:00+00:00,1450.42,24585.31,2020-07,salary
2020-07-18 00:00:00+00:00,82.21,24503.1,2020-07,finances
2020-07-17 00:00:00+00:00,137.6,24365.5,2020-07,transfer
2020-07-17 00:00:00+00:00,-12.12,24377.62,2020-07,finances
2020-07-17 00:00:00+00:00,-40.0,24417.62,2020-07,finances
2020-07-17 00:00:00+00:00,-25.01,24442.63,2020-07,transport
2020-07-17 00:00:00+00:00,-0.61,24443.24,2020-07,savings
2020-07-17 00:00:00+00:00,-1.76,24445.0,2020-07,groceries / food spend
2020-07-15 00:00:00+00:00,-43.89,24488.89,2020-07,groceries / food spend
2020-07-15 00:00:00+00:00,-0.59,24489.48,2020-07,savings
2020-07-15 00:00:00+00:00,-15.45,24504.93,2020-07,shopping
2020-07-15 00:00:00+00:00,-0.5,24505.43,2020-07,savings
2020-07-15 00:00:00+00:00,-3.59,24509.02,2020-07,shopping
2020-07-15 00:00:00+00:00,-10.0,24519.02,2020-07,shopping
2020-07-14 00:00:00+00:00,-2.0,24521.02,2020-07,entertainment
2020-07-14 00:00:00+00:00,-20.5,24541.52,2020-07,entertainment
2020-07-14 00:00:00+00:00,86.83,24454.69,2020-07,entertainment
2020-07-12 00:00:00+00:00,-0.42,24455.11,2020-07,savings
2020-07-12 00:00:00+00:00,-17.61,24472.72,2020-07,transport
2020-07-11 00:00:00+00:00,55.72,24417.0,2020-07,finances
2020-07-11 00:00:00+00:00,50.0,24367.0,2020-07,transfer
2020-07-11 00:00:00+00:00,21.15,24345.85,2020-07,taxes
2020-07-11 00:00:00+00:00,-20.78,24366.63,2020-07,holidays
2020-07-10 00:00:00+00:00,-21.77,24388.4,2020-07,finances
2020-07-10 00:00:00+00:00,-5.0,24393.4,2020-07,groceries / food spend
2020-07-10 00:00:00+00:00,40.0,24353.4,2020-07,transfer
2020-07-10 00:00:00+00:00,50.36,24303.04,2020-07,finances
2020-07-10 00:00:00+00:00,-41.15,24344.19,2020-07,transfer
2020-07-10 00:00:00+00:00,-24.63,24368.82,2020-07,bills and utilities
2020-07-09 00:00:00+00:00,-23.62,24392.44,2020-07,transport
2020-07-09 00:00:00+00:00,-19.94,24412.38,2020-07,taxes
2020-07-09 00:00:00+00:00,-0.38,24412.76,2020-07,savings
2020-07-09 00:00:00+00:00,70.0,24342.76,2020-07,transfer
2020-07-08 00:00:00+00:00,-0.01,24342.77,2020-07,savings
2020-07-08 00:00:00+00:00,22.76,24320.01,2020-07,taxes
2020-07-08 00:00:00+00:00,-14.99,24335.0,2020-07,fees and charges
2020-07-08 00:00:00+00:00,-100.0,24435.0,2020-07,rent
2020-07-08 00:00:00+00:00,-10.0,24445.0,2020-07,entertainment
2020-07-08 00:00:00+00:00,-0.69,24445.69,2020-07,savings
2020-07-08 00:00:00+00:00,-1.02,24446.71,2020-07,savings
2020-07-08 00:00:00+00:00,-24.31,24471.02,2020-07,groceries / food spend
2020-07-07 00:00:00+00:00,-82.37,24553.39,2020-07,bills and utilities
2020-07-07 00:00:00+00:00,-1.24,24554.63,2020-07,savings
2020-07-07 00:00:00+00:00,-70.0,24624.63,2020-07,transfer
2020-07-06 00:00:00+00:00,-23.0,24647.63,2020-07,bills and utilities
2020-07-06 00:00:00+00:00,20.61,24627.02,2020-07,taxes
2020-07-06 00:00:00+00:00,-19.69,24646.71,2020-07,groceries / food spend
2020-07-06 00:00:00+00:00,-50.0,24696.71,2020-07,bills and utilities
2020-07-06 00:00:00+00:00,-3.65,24700.36,2020-07,home and garden
2020-07-06 00:00:00+00:00,359.56,24340.8,2020-07,taxes
2020-07-06 00:00:00+00:00,181.61,24159.19,2020-07,transfer
2020-07-06 00:00:00+00:00,61.89,24097.3,2020-07,transfer
2020-07-06 00:00:00+00:00,-0.01,24097.31,2020-07,savings
2020-07-06 00:00:00+00:00,-5.0,24102.31,2020-07,shopping
2020-07-05 00:00:00+00:00,-57.76,24160.07,2020-07,transfer
2020-07-05 00:00:00+00:00,-1.89,24161.96,2020-07,savings
2020-07-05 00:00:00+00:00,-3.81,24165.77,2020-07,finances
2020-07-05 00:00:00+00:00,-15.68,24181.45,2020-07,shopping
2020-07-05 00:00:00+00:00,-39.43,24220.88,2020-07,transfer
2020-07-05 00:00:00+00:00,-19.49,24240.37,2020-07,finances
2020-07-05 00:00:00+00:00,-6.37,24246.74,2020-07,groceries / food spend
2020-07-05 00:00:00+00:00,-37.31,24284.05,2020-07,shopping
2020-07-04 00:00:00+00:00,10.0,24274.05,2020-07,transfer
2020-07-04 00:00:00+00:00,70.0,24204.05,2020-07,transfer
2020-07-04 00:00:00+00:00,68.47,24135.58,2020-07,transfer
2020-07-04 00:00:00+00:00,-13.29,24148.87,2020-07,transfer
2020-07-04 00:00:00+00:00,-5.0,24153.87,2020-07,shopping
2020-07-04 00:00:00+00:00,-3.07,24156.94,2020-07,finances
2020-07-04 00:00:00+00:00,-216.89,24373.83,2020-07,transfer
2020-07-04 00:00:00+00:00,100.0,24273.83,2020-07,transfer
2020-07-04 00:00:00+00:00,-3.59,24277.42,2020-07,business services
2020-07-04 00:00:00+00:00,12.57,24264.85,2020-07,transfer
2020-07-04 00:00:00+00:00,-130.0,24394.85,2020-07,rent
2020-07-03 00:00:00+00:00,0.89,24393.96,2020-07,transfer
2020-07-03 00:00:00+00:00,-0.47,24394.43,2020-07,savings
2020-07-03 00:00:00+00:00,13.88,24380.55,2020-07,transfer
2020-07-03 00:00:00+00:00,8.76,24371.79,2020-07,transfer
2020-07-03 00:00:00+00:00,-23.11,24394.9,2020-07,transport
2020-07-03 00:00:00+00:00,35.49,24359.41,2020-07,entertainment
2020-07-03 00:00:00+00:00,-0.01,24359.42,2020-07,savings
2020-07-03 00:00:00+00:00,1.25,24358.17,2020-07,entertainment
2020-07-03 00:00:00+00:00,-15.66,24373.83,2020-07,shopping
2020-07-03 00:00:00+00:00,40.0,24333.83,2020-07,transfer
2020-07-03 00:00:00+00:00,-40.0,24373.83,2020-07,transfer
2020-07-03 00:00:00+00:00,-5.0,24378.83,2020-07,groceries / food spend
2020-07-02 00:00:00+00:00,8.05,24370.78,2020-07,transfer
2020-07-02 00:00:00+00:00,-28.72,24399.5,2020-07,transfer
2020-07-02 00:00:00+00:00,13.35,24386.15,2020-07,transfer
2020-07-02 00:00:00+00:00,-0.59,24386.74,2020-07,savings
2020-07-01 00:00:00+00:00,-54.87,24441.61,2020-07,bills and utilities
2020-07-01 00:00:00+00:00,-0.01,24441.62,2020-07,fees and charges
2020-07-01 00:00:00+00:00,-227.0,24668.62,2020-07,transfer
2020-07-01 00:00:00+00:00,-39.99,24708.61,2020-07,groceries / food spend
2020-07-01 00:00:00+00:00,-0.01,24708.62,2020-07,finances
2020-07-01 00:00:00+00:00,-0.01,24708.63,2020-07,shopping
2020-07-01 00:00:00+00:00,-0.01,24708.64,2020-07,shopping
2020-07-01 00:00:00+00:00,-0.01,24708.65,2020-07,groceries / food spend
2020-07-01 00:00:00+00:00,-0.01,24708.66,2020-07,groceries / food spend
2020-07-01 00:00:00+00:00,-0.01,24708.67,2020-07,groceries / food spend
2020-07-01 00:00:00+00:00,-0.01,24708.68,2020-07,groceries / food spend
2020-07-01 00:00:00+00:00,-0.01,24708.69,2020-07,transport
2020-07-01 00:00:00+00:00,-353.15,25061.84,2020-07,restaurants / eating out / delivery
2020-07-01 00:00:00+00:00,-0.01,25061.85,2020-07,home and garden
2020-07-01 00:00:00+00:00,-0.01,25061.86,2020-07,fees and charges
2020-07-01 00:00:00+00:00,-0.01,25061.87,2020-07,transport
2020-07-01 00:00:00+00:00,-0.01,25061.88,2020-07,entertainment
2020-07-01 00:00:00+00:00,-0.02,25061.9,2020-07,fees and charges
2020-07-01 00:00:00+00:00,28.0,25033.9,2020-07,groceries / food spend
2020-07-01 00:00:00+00:00,-20.91,25054.81,2020-07,transfer
2020-07-01 00:00:00+00:00,-5.44,25060.25,2020-07,business services
2020-07-01 00:00:00+00:00,-9.75,25070.0,2020-07,bills and utilities
2020-07-01 00:00:00+00:00,-10.0,25080.0,2020-07,finances
2020-07-01 00:00:00+00:00,-10.0,25090.0,2020-07,finances
2020-07-01 00:00:00+00:00,-9.68,25099.68,2020-07,bills and utilities
2020-06-28 00:00:00+00:00,416.08,24683.6,2020-06,transfer
2020-06-28 00:00:00+00:00,-4.53,24688.13,2020-06,shopping
2020-06-28 00:00:00+00:00,40.0,24648.13,2020-06,transfer
2020-06-28 00:00:00+00:00,-32.72,24680.85,2020-06,transfer
2020-06-28 00:00:00+00:00,22.42,24658.43,2020-06,taxes
2020-06-27 00:00:00+00:00,-7.93,24666.36,2020-06,transfer
2020-06-27 00:00:00+00:00,18.99,24647.37,2020-06,transfer
2020-06-27 00:00:00+00:00,15.86,24631.51,2020-06,transfer
2020-06-27 00:00:00+00:00,-20.19,24651.7,2020-06,transport
2020-06-27 00:00:00+00:00,-2.99,24654.69,2020-06,finances
2020-06-27 00:00:00+00:00,-23.62,24678.31,2020-06,groceries / food spend
2020-06-27 00:00:00+00:00,-0.36,24678.67,2020-06,shopping
2020-06-25 00:00:00+00:00,70.0,24608.67,2020-06,transfer
2020-06-25 00:00:00+00:00,-19.59,24628.26,2020-06,entertainment
2020-06-25 00:00:00+00:00,-10.14,24638.4,2020-06,transfer
2020-06-25 00:00:00+00:00,-0.49,24638.89,2020-06,savings
2020-06-25 00:00:00+00:00,-36.59,24675.48,2020-06,shopping
2020-06-25 00:00:00+00:00,-0.6,24676.08,2020-06,savings
2020-06-25 00:00:00+00:00,2.36,24673.72,2020-06,entertainment
2020-06-23 00:00:00+00:00,-23.86,24697.58,2020-06,finances
2020-06-23 00:00:00+00:00,35.62,24661.96,2020-06,transfer
2020-06-23 00:00:00+00:00,-100.0,24761.96,2020-06,transfer
2020-06-23 00:00:00+00:00,-1.57,24763.53,2020-06,savings
2020-06-23 00:00:00+00:00,-20.0,24783.53,2020-06,transfer
2020-06-22 00:00:00+00:00,-5.0,24788.53,2020-06,shopping
2020-06-22 00:00:00+00:00,-0.01,24788.54,2020-06,savings
2020-06-22 00:00:00+00:00,-39.25,24827.79,2020-06,bills and utilities
2020-06-22 00:00:00+00:00,-40.21,24868.0,2020-06,shopping
2020-06-22 00:00:00+00:00,-36.59,24904.59,2020-06,finances
2020-06-20 00:00:00+00:00,-150.0,25054.59,2020-06,rent
2020-06-20 00:00:00+00:00,22.42,25032.17,2020-06,taxes
2020-06-20 00:00:00+00:00,-710.18,25742.35,2020-06,business services
2020-06-20 00:00:00+00:00,345.13,25397.22,2020-06,taxes
2020-06-19 00:00:00+00:00,-17.56,25414.78,2020-06,shopping
2020-06-19 00:00:00+00:00,1450.42,23964.36,2020-06,salary
2020-06-18 00:00:00+00:00,82.21,23882.15,2020-06,finances
2020-06-17 00:00:00+00:00,99.54,23782.61,2020-06,transfer
2020-06-17 00:00:00+00:00,-12.73,23795.34,2020-06,finances
2020-06-17 00:00:00+00:00,-47.37,23842.71,2020-06,finances
2020-06-17 00:00:00+00:00,-17.5,23860.21,2020-06,transport
2020-06-17 00:00:00+00:00,-0.63,23860.84,2020-06,savings
2020-06-17 00:00:00+00:00,-5.78,23866.62,2020-06,groceries / food spend
2020-06-15 00:00:00+00:00,-45.69,23912.31,2020-06,groceries / food spend
2020-06-15 00:00:00+00:00,-0.55,23912.86,2020-06,savings
2020-06-15 00:00:00+00:00,-7.0,23919.86,2020-06,shopping
2020-06-15 00:00:00+00:00,-0.49,23920.35,2020-06,savings
2020-06-15 00:00:00+00:00,-8.72,23929.07,2020-06,shopping
2020-06-15 00:00:00+00:00,-9.07,23938.14,2020-06,shopping
2020-06-14 00:00:00+00:00,-5.75,23943.89,2020-06,entertainment
2020-06-14 00:00:00+00:00,-44.59,23988.48,2020-06,entertainment
2020-06-14 00:00:00+00:00,43.5,23944.98,2020-06,entertainment
2020-06-12 00:00:00+00:00,-0.41,23945.39,2020-06,savings
2020-06-12 00:00:00+00:00,-23.11,23968.5,2020-06,transport
2020-06-11 00:00:00+00:00,51.08,23917.42,2020-06,finances
2020-06-11 00:00:00+00:00,50.0,23867.42,2020-06,transfer
2020-06-11 00:00:00+00:00,22.42,23845.0,2020-06,taxes
2020-06-11 00:00:00+00:00,-17.0,23862.0,2020-06,holidays
2020-06-10 00:00:00+00:00,-36.02,23898.02,2020-06,finances
2020-06-10 00:00:00+00:00,-5.0,23903.02,2020-06,groceries / food spend
2020-06-10 00:00:00+00:00,87.31,23815.71,2020-06,transfer
2020-06-10 00:00:00+00:00,63.94,23751.77,2020-06,finances
2020-06-10 00:00:00+00:00,-66.95,23818.72,2020-06,transfer
2020-06-10 00:00:00+00:00,-24.5,23843.22,2020-06,bills and utilities
2020-06-09 00:00:00+00:00,-23.62,23866.84,2020-06,transport
2020-06-09 00:00:00+00:00,-20.56,23887.4,2020-06,taxes
2020-06-09 00:00:00+00:00,-0.41,23887.81,2020-06,savings
2020-06-09 00:00:00+00:00,82.15,23805.66,2020-06,transfer
2020-06-08 00:00:00+00:00,-0.01,23805.67,2020-06,savings
2020-06-08 00:00:00+00:00,22.42,23783.25,2020-06,taxes
2020-06-08 00:00:00+00:00,-8.99,23792.24,2020-06,fees and charges
2020-06-08 00:00:00+00:00,-100.0,23892.24,2020-06,rent
2020-06-08 00:00:00+00:00,-10.0,23902.24,2020-06,entertainment
2020-06-08 00:00:00+00:00,-0.69,23902.93,2020-06,savings
2020-06-08 00:00:00+00:00,-1.04,23903.97,2020-06,savings
2020-06-08 00:00:00+00:00,-30.93,23934.9,2020-06,groceries / food spend
2020-06-07 00:00:00+00:00,-85.45,24020.35,2020-06,bills and utilities
2020-06-07 00:00:00+00:00,-1.15,24021.5,2020-06,savings
2020-06-07 00:00:00+00:00,-61.85,24083.35,2020-06,transfer
2020-06-06 00:00:00+00:00,-28.25,24111.6,2020-06,bills and utilities
2020-06-06 00:00:00+00:00,21.88,24089.72,2020-06,taxes
2020-06-06 00:00:00+00:00,-35.28,24125.0,2020-06,groceries / food spend
2020-06-06 00:00:00+00:00,-50.0,24175.0,2020-06,bills and utilities
2020-06-06 00:00:00+00:00,-3.32,24178.32,2020-06,home and garden
2020-06-06 00:00:00+00:00,335.37,23842.95,2020-06,taxes
2020-06-06 00:00:00+00:00,163.75,23679.2,2020-06,transfer
2020-06-06 00:00:00+00:00,39.9,23639.3,2020-06,transfer
2020-06-06 00:00:00+00:00,-0.01,23639.31,2020-06,savings
2020-06-06 00:00:00+00:00,-5.0,23644.31,2020-06,shopping
2020-06-05 00:00:00+00:00,-49.37,23693.68,2020-06,transfer
2020-06-05 00:00:00+00:00,-1.89,23695.57,2020-06,savings
2020-06-05 00:00:00+00:00,-5.79,23701.36,2020-06,finances
2020-06-05 00:00:00+00:00,-14.55,23715.91,2020-06,shopping
2020-06-05 00:00:00+00:00,-16.77,23732.68,2020-06,transfer
2020-06-05 00:00:00+00:00,-10.49,23743.17,2020-06,finances
2020-06-05 00:00:00+00:00,-6.67,23749.84,2020-06,groceries / food spend
2020-06-05 00:00:00+00:00,-20.0,23769.84,2020-06,shopping
2020-06-04 00:00:00+00:00,10.0,23759.84,2020-06,transfer
2020-06-04 00:00:00+00:00,19.25,23740.59,2020-06,transfer
2020-06-04 00:00:00+00:00,59.17,23681.42,2020-06,transfer
2020-06-04 00:00:00+00:00,-19.99,23701.41,2020-06,transfer
2020-06-04 00:00:00+00:00,-5.0,23706.41,2020-06,shopping
2020-06-04 00:00:00+00:00,-3.28,23709.69,2020-06,finances
2020-06-04 00:00:00+00:00,-104.77,23814.46,2020-06,transfer
2020-06-04 00:00:00+00:00,131.07,23683.39,2020-06,transfer
2020-06-04 00:00:00+00:00,-3.59,23686.98,2020-06,business services
2020-06-04 00:00:00+00:00,21.07,23665.91,2020-06,transfer
2020-06-04 00:00:00+00:00,-130.0,23795.91,2020-06,rent
2020-06-03 00:00:00+00:00,0.89,23795.02,2020-06,transfer
2020-06-03 00:00:00+00:00,-0.41,23795.43,2020-06,savings
2020-06-03 00:00:00+00:00,130.0,23665.43,2020-06,transfer
2020-06-03 00:00:00+00:00,9.22,23656.21,2020-06,transfer
2020-06-03 00:00:00+00:00,-18.71,23674.92,2020-06,transport
2020-06-03 00:00:00+00:00,35.49,23639.43,2020-06,entertainment
2020-06-03 00:00:00+00:00,-0.01,23639.44,2020-06,savings
2020-06-03 00:00:00+00:00,-2.99,23642.43,2020-06,entertainment
2020-06-03 00:00:00+00:00,-30.0,23672.43,2020-06,shopping
2020-06-03 00:00:00+00:00,61.57,23610.86,2020-06,transfer
2020-06-03 00:00:00+00:00,-40.0,23650.86,2020-06,transfer
2020-06-03 00:00:00+00:00,-8.94,23659.8,2020-06,groceries / food spend
2020-06-02 00:00:00+00:00,48.77,23611.03,2020-06,transfer
2020-06-02 00:00:00+00:00,-26.84,23637.87,2020-06,transfer
2020-06-02 00:00:00+00:00,11.5,23626.37,2020-06,transfer
2020-06-02 00:00:00+00:00,-0.59,23626.96,2020-06,savings
2020-06-01 00:00:00+00:00,-46.82,23673.78,2020-06,bills and utilities
2020-06-01 00:00:00+00:00,-0.01,23673.79,2020-06,fees and charges
2020-06-01 00:00:00+00:00,-323.41,23997.2,2020-06,transfer
2020-06-01 00:00:00+00:00,-39.99,24037.19,2020-06,groceries / food spend
2020-06-01 00:00:00+00:00,-0.01,24037.2,2020-06,finances
2020-06-01 00:00:00+00:00,-0.01,24037.21,2020-06,shopping
2020-06-01 00:00:00+00:00,-0.01,24037.22,2020-06,shopping
2020-06-01 00:00:00+00:00,-0.02,24037.24,2020-06,groceries / food spend
2020-06-01 00:00:00+00:00,-0.01,24037.25,2020-06,groceries / food spend
2020-06-01 00:00:00+00:00,-0.0,24037.25,2020-06,groceries / food spend
2020-06-01 00:00:00+00:00,-0.01,24037.26,2020-06,groceries / food spend
2020-06-01 00:00:00+00:00,-0.01,24037.27,2020-06,transport
2020-06-01 00:00:00+00:00,-200.0,24237.27,2020-06,restaurants / eating out / delivery
2020-06-01 00:00:00+00:00,-0.01,24237.28,2020-06,home and garden
2020-06-01 00:00:00+00:00,-0.01,24237.29,2020-06,fees and charges
2020-06-01 00:00:00+00:00,-0.01,24237.3,2020-06,transport
2020-06-01 00:00:00+00:00,-0.01,24237.31,2020-06,entertainment
2020-06-01 00:00:00+00:00,-0.02,24237.33,2020-06,fees and charges
2020-06-01 00:00:00+00:00,-23.99,24261.32,2020-06,groceries / food spend
2020-06-01 00:00:00+00:00,-20.91,24282.23,2020-06,transfer
2020-06-01 00:00:00+00:00,-16.77,24299.0,2020-06,business services
2020-06-01 00:00:00+00:00,-10.0,24309.0,2020-06,bills and utilities
2020-06-01 00:00:00+00:00,-10.21,24319.21,2020-06,finances
2020-06-01 00:00:00+00:00,-7.77,24326.98,2020-06,finances
2020-06-01 00:00:00+00:00,-10.0,24336.98,2020-06,bills and utilities
2020-05-28 00:00:00+00:00,420.0,23916.98,2020-05,transfer
2020-05-28 00:00:00+00:00,-36.59,23953.57,2020-05,shopping
2020-05-28 00:00:00+00:00,40.0,23913.57,2020-05,transfer
2020-05-28 00:00:00+00:00,-32.72,23946.29,2020-05,transfer
2020-05-28 00:00:00+00:00,21.74,23924.55,2020-05,taxes
2020-05-27 00:00:00+00:00,-7.93,23932.48,2020-05,transfer
2020-05-27 00:00:00+00:00,50.59,23881.89,2020-05,transfer
2020-05-27 00:00:00+00:00,15.86,23866.03,2020-05,transfer
2020-05-27 00:00:00+00:00,-20.56,23886.59,2020-05,transport
2020-05-27 00:00:00+00:00,-2.2,23888.79,2020-05,finances
2020-05-27 00:00:00+00:00,-34.43,23923.22,2020-05,groceries / food spend
2020-05-27 00:00:00+00:00,-14.44,23937.66,2020-05,shopping
2020-05-25 00:00:00+00:00,70.0,23867.66,2020-05,transfer
2020-05-25 00:00:00+00:00,-43.08,23910.74,2020-05,entertainment
2020-05-25 00:00:00+00:00,-10.0,23920.74,2020-05,transfer
2020-05-25 00:00:00+00:00,-0.44,23921.18,2020-05,savings
2020-05-25 00:00:00+00:00,-36.59,23957.77,2020-05,shopping
2020-05-25 00:00:00+00:00,-0.52,23958.29,2020-05,savings
2020-05-25 00:00:00+00:00,-14.88,23973.17,2020-05,entertainment
2020-05-23 00:00:00+00:00,-30.0,24003.17,2020-05,finances
2020-05-23 00:00:00+00:00,23.93,23979.24,2020-05,transfer
2020-05-23 00:00:00+00:00,-100.0,24079.24,2020-05,transfer
2020-05-23 00:00:00+00:00,-1.57,24080.81,2020-05,savings
2020-05-23 00:00:00+00:00,-20.0,24100.81,2020-05,transfer
2020-05-22 00:00:00+00:00,-2.66,24103.47,2020-05,shopping
2020-05-22 00:00:00+00:00,-0.01,24103.48,2020-05,savings
2020-05-22 00:00:00+00:00,-36.27,24139.75,2020-05,bills and utilities
2020-05-22 00:00:00+00:00,-75.35,24215.1,2020-05,shopping
2020-05-22 00:00:00+00:00,-36.59,24251.69,2020-05,finances
2020-05-20 00:00:00+00:00,-150.0,24401.69,2020-05,rent
2020-05-20 00:00:00+00:00,22.42,24379.27,2020-05,taxes
2020-05-20 00:00:00+00:00,-434.98,24814.25,2020-05,business services
2020-05-20 00:00:00+00:00,345.13,24469.12,2020-05,taxes
2020-05-19 00:00:00+00:00,-7.99,24477.11,2020-05,shopping
2020-05-19 00:00:00+00:00,1450.42,23026.69,2020-05,salary
2020-05-18 00:00:00+00:00,73.4,22953.29,2020-05,finances
2020-05-17 00:00:00+00:00,137.6,22815.69,2020-05,transfer
2020-05-17 00:00:00+00:00,-12.33,22828.02,2020-05,finances
2020-05-17 00:00:00+00:00,-33.51,22861.53,2020-05,finances
2020-05-17 00:00:00+00:00,-14.69,22876.22,2020-05,transport
2020-05-17 00:00:00+00:00,-0.63,22876.85,2020-05,savings
2020-05-17 00:00:00+00:00,-6.37,22883.22,2020-05,groceries / food spend
2020-05-15 00:00:00+00:00,-32.0,22915.22,2020-05,groceries / food spend
2020-05-15 00:00:00+00:00,-0.44,22915.66,2020-05,savings
2020-05-15 00:00:00+00:00,-32.78,22948.44,2020-05,shopping
2020-05-15 00:00:00+00:00,-0.5,22948.94,2020-05,savings
2020-05-15 00:00:00+00:00,-3.59,22952.53,2020-05,shopping
2020-05-15 00:00:00+00:00,-10.0,22962.53,2020-05,shopping
2020-05-14 00:00:00+00:00,-2.0,22964.53,2020-05,entertainment
2020-05-14 00:00:00+00:00,-20.5,22985.03,2020-05,entertainment
2020-05-14 00:00:00+00:00,43.5,22941.53,2020-05,entertainment
2020-05-12 00:00:00+00:00,-0.44,22941.97,2020-05,savings
2020-05-12 00:00:00+00:00,-10.21,22952.18,2020-05,transport
2020-05-11 00:00:00+00:00,50.0,22902.18,2020-05,finances
2020-05-11 00:00:00+00:00,50.0,22852.18,2020-05,transfer
2020-05-11 00:00:00+00:00,21.9,22830.28,2020-05,taxes
2020-05-11 00:00:00+00:00,-27.59,22857.87,2020-05,holidays
2020-05-10 00:00:00+00:00,-43.91,22901.78,2020-05,finances
2020-05-10 00:00:00+00:00,-3.13,22904.91,2020-05,groceries / food spend
2020-05-10 00:00:00+00:00,33.94,22870.97,2020-05,transfer
2020-05-10 00:00:00+00:00,48.07,22822.9,2020-05,finances
2020-05-10 00:00:00+00:00,-40.11,22863.01,2020-05,transfer
2020-05-10 00:00:00+00:00,-20.8,22883.81,2020-05,bills and utilities
2020-05-09 00:00:00+00:00,-36.05,22919.86,2020-05,transport
2020-05-09 00:00:00+00:00,-20.56,22940.42,2020-05,taxes
2020-05-09 00:00:00+00:00,-0.41,22940.83,2020-05,savings
2020-05-09 00:00:00+00:00,106.21,22834.62,2020-05,transfer
2020-05-08 00:00:00+00:00,-0.01,22834.63,2020-05,savings
2020-05-08 00:00:00+00:00,22.42,22812.21,2020-05,taxes
2020-05-08 00:00:00+00:00,-20.53,22832.74,2020-05,fees and charges
2020-05-08 00:00:00+00:00,-100.0,22932.74,2020-05,rent
2020-05-08 00:00:00+00:00,-10.0,22942.74,2020-05,entertainment
2020-05-08 00:00:00+00:00,-0.76,22943.5,2020-05,savings
2020-05-08 00:00:00+00:00,-1.01,22944.51,2020-05,savings
2020-05-08 00:00:00+00:00,-24.31,22968.82,2020-05,groceries / food spend
2020-05-07 00:00:00+00:00,-82.37,23051.19,2020-05,bills and utilities
2020-05-07 00:00:00+00:00,-0.97,23052.16,2020-05,savings
2020-05-07 00:00:00+00:00,-0.41,23052.57,2020-05,transfer
2020-05-06 00:00:00+00:00,-33.49,23086.06,2020-05,bills and utilities
2020-05-06 00:00:00+00:00,22.42,23063.64,2020-05,taxes
2020-05-06 00:00:00+00:00,-12.89,23076.53,2020-05,groceries / food spend
2020-05-06 00:00:00+00:00,-50.0,23126.53,2020-05,bills and utilities
2020-05-06 00:00:00+00:00,-9.71,23136.24,2020-05,home and garden
2020-05-06 00:00:00+00:00,308.24,22828.0,2020-05,taxes
2020-05-06 00:00:00+00:00,194.68,22633.32,2020-05,transfer
2020-05-06 00:00:00+00:00,61.89,22571.43,2020-05,transfer
2020-05-06 00:00:00+00:00,-0.01,22571.44,2020-05,savings
2020-05-06 00:00:00+00:00,-5.0,22576.44,2020-05,shopping
2020-05-05 00:00:00+00:00,-60.0,22636.44,2020-05,transfer
2020-05-05 00:00:00+00:00,-1.89,22638.33,2020-05,savings
2020-05-05 00:00:00+00:00,-5.79,22644.12,2020-05,finances
2020-05-05 00:00:00+00:00,-11.74,22655.86,2020-05,shopping
2020-05-05 00:00:00+00:00,-39.57,22695.43,2020-05,transfer
2020-05-05 00:00:00+00:00,-12.73,22708.16,2020-05,finances
2020-05-05 00:00:00+00:00,-6.37,22714.53,2020-05,groceries / food spend
2020-05-05 00:00:00+00:00,-23.67,22738.2,2020-05,shopping
2020-05-04 00:00:00+00:00,8.28,22729.92,2020-05,transfer
2020-05-04 00:00:00+00:00,70.0,22659.92,2020-05,transfer
2020-05-04 00:00:00+00:00,19.66,22640.26,2020-05,transfer
2020-05-04 00:00:00+00:00,-28.48,22668.74,2020-05,transfer
2020-05-04 00:00:00+00:00,-5.0,22673.74,2020-05,shopping
2020-05-04 00:00:00+00:00,-3.49,22677.23,2020-05,finances
2020-05-04 00:00:00+00:00,-100.0,22777.23,2020-05,transfer
2020-05-04 00:00:00+00:00,74.47,22702.76,2020-05,transfer
2020-05-04 00:00:00+00:00,-3.59,22706.35,2020-05,business services
2020-05-04 00:00:00+00:00,38.37,22667.98,2020-05,transfer
2020-05-04 00:00:00+00:00,-130.0,22797.98,2020-05,rent
2020-05-03 00:00:00+00:00,0.89,22797.09,2020-05,transfer
2020-05-03 00:00:00+00:00,-0.41,22797.5,2020-05,savings
2020-05-03 00:00:00+00:00,66.4,22731.1,2020-05,transfer
2020-05-03 00:00:00+00:00,7.45,22723.65,2020-05,transfer
2020-05-03 00:00:00+00:00,-10.66,22734.31,2020-05,transport
2020-05-03 00:00:00+00:00,-19.65,22753.96,2020-05,entertainment
2020-05-03 00:00:00+00:00,-0.01,22753.97,2020-05,savings
2020-05-03 00:00:00+00:00,-2.99,22756.96,2020-05,entertainment
2020-05-03 00:00:00+00:00,-44.62,22801.58,2020-05,shopping
2020-05-03 00:00:00+00:00,34.77,22766.81,2020-05,transfer
2020-05-03 00:00:00+00:00,-47.75,22814.56,2020-05,transfer
2020-05-03 00:00:00+00:00,-5.0,22819.56,2020-05,groceries / food spend
2020-05-02 00:00:00+00:00,48.89,22770.67,2020-05,transfer
2020-05-02 00:00:00+00:00,-32.59,22803.26,2020-05,transfer
2020-05-02 00:00:00+00:00,10.0,22793.26,2020-05,transfer
2020-05-02 00:00:00+00:00,-0.66,22793.92,2020-05,savings
2020-05-01 00:00:00+00:00,-46.82,22840.74,2020-05,bills and utilities
2020-05-01 00:00:00+00:00,-0.01,22840.75,2020-05,fees and charges
2020-05-01 00:00:00+00:00,-227.0,23067.75,2020-05,transfer
2020-05-01 00:00:00+00:00,-80.79,23148.54,2020-05,groceries / food spend
2020-05-01 00:00:00+00:00,-0.01,23148.55,2020-05,finances
2020-05-01 00:00:00+00:00,-0.01,23148.56,2020-05,shopping
2020-05-01 00:00:00+00:00,-0.01,23148.57,2020-05,shopping
2020-05-01 00:00:00+00:00,-0.0,23148.57,2020-05,groceries / food spend
2020-05-01 00:00:00+00:00,-0.01,23148.58,2020-05,groceries / food spend
2020-05-01 00:00:00+00:00,-0.01,23148.59,2020-05,groceries / food spend
2020-05-01 00:00:00+00:00,-0.01,23148.6,2020-05,groceries / food spend
2020-05-01 00:00:00+00:00,-0.01,23148.61,2020-05,transport
2020-05-01 00:00:00+00:00,-200.0,23348.61,2020-05,restaurants / eating out / delivery
2020-05-01 00:00:00+00:00,-0.01,23348.62,2020-05,home and garden
2020-05-01 00:00:00+00:00,-0.01,23348.63,2020-05,fees and charges
2020-05-01 00:00:00+00:00,-0.01,23348.64,2020-05,transport
2020-05-01 00:00:00+00:00,-0.01,23348.65,2020-05,entertainment
2020-05-01 00:00:00+00:00,-0.0,23348.65,2020-05,fees and charges
2020-05-01 00:00:00+00:00,-23.99,23372.64,2020-05,groceries / food spend
2020-05-01 00:00:00+00:00,-7.3,23379.94,2020-05,transfer
2020-05-01 00:00:00+00:00,-10.0,23389.94,2020-05,business services
2020-05-01 00:00:00+00:00,-9.61,23399.55,2020-05,bills and utilities
2020-05-01 00:00:00+00:00,-10.0,23409.55,2020-05,finances
2020-05-01 00:00:00+00:00,-10.0,23419.55,2020-05,finances
2020-05-01 00:00:00+00:00,-10.0,23429.55,2020-05,bills and utilities
2020-04-28 00:00:00+00:00,594.79,22834.76,2020-04,transfer
2020-04-28 00:00:00+00:00,-34.92,22869.68,2020-04,shopping
2020-04-28 00:00:00+00:00,40.0,22829.68,2020-04,transfer
2020-04-28 00:00:00+00:00,-43.56,22873.24,2020-04,transfer
2020-04-28 00:00:00+00:00,22.42,22850.82,2020-04,taxes
2020-04-27 00:00:00+00:00,-7.93,22858.75,2020-04,transfer
2020-04-27 00:00:00+00:00,50.59,22808.16,2020-04,transfer
2020-04-27 00:00:00+00:00,15.86,22792.3,2020-04,transfer
2020-04-27 00:00:00+00:00,-7.28,22799.58,2020-04,transport
2020-04-27 00:00:00+00:00,-2.81,22802.39,2020-04,finances
2020-04-27 00:00:00+00:00,-54.79,22857.18,2020-04,groceries / food spend
2020-04-27 00:00:00+00:00,-7.56,22864.74,2020-04,shopping
2020-04-25 00:00:00+00:00,136.33,22728.41,2020-04,transfer
2020-04-25 00:00:00+00:00,-24.5,22752.91,2020-04,entertainment
2020-04-25 00:00:00+00:00,-17.94,22770.85,2020-04,transfer
2020-04-25 00:00:00+00:00,-0.41,22771.26,2020-04,savings
2020-04-25 00:00:00+00:00,-36.59,22807.85,2020-04,shopping
2020-04-25 00:00:00+00:00,-0.46,22808.31,2020-04,savings
2020-04-25 00:00:00+00:00,-21.94,22830.25,2020-04,entertainment
2020-04-23 00:00:00+00:00,-30.0,22860.25,2020-04,finances
2020-04-23 00:00:00+00:00,32.5,22827.75,2020-04,transfer
2020-04-23 00:00:00+00:00,-100.0,22927.75,2020-04,transfer
2020-04-23 00:00:00+00:00,-1.44,22929.19,2020-04,savings
2020-04-23 00:00:00+00:00,-34.86,22964.05,2020-04,transfer
2020-04-22 00:00:00+00:00,-5.0,22969.05,2020-04,shopping
2020-04-22 00:00:00+00:00,-0.01,22969.06,2020-04,savings
2020-04-22 00:00:00+00:00,-42.6,23011.66,2020-04,bills and utilities
2020-04-22 00:00:00+00:00,-36.59,23048.25,2020-04,shopping
2020-04-22 00:00:00+00:00,-44.45,23092.7,2020-04,finances
2020-04-20 00:00:00+00:00,-150.0,23242.7,2020-04,rent
2020-04-20 00:00:00+00:00,23.25,23219.45,2020-04,taxes
2020-04-20 00:00:00+00:00,-886.8,24106.25,2020-04,business services
2020-04-20 00:00:00+00:00,345.13,23761.12,2020-04,taxes
2020-04-19 00:00:00+00:00,-8.72,23769.84,2020-04,shopping
2020-04-19 00:00:00+00:00,1450.42,22319.42,2020-04,salary
2020-04-18 00:00:00+00:00,82.21,22237.21,2020-04,finances
2020-04-17 00:00:00+00:00,50.16,22187.05,2020-04,transfer
2020-04-17 00:00:00+00:00,-9.72,22196.77,2020-04,finances
2020-04-17 00:00:00+00:00,-40.0,22236.77,2020-04,finances
2020-04-17 00:00:00+00:00,-20.0,22256.77,2020-04,transport
2020-04-17 00:00:00+00:00,-0.66,22257.43,2020-04,savings
2020-04-17 00:00:00+00:00,-6.37,22263.8,2020-04,groceries / food spend
2020-04-15 00:00:00+00:00,-32.0,22295.8,2020-04,groceries / food spend
2020-04-15 00:00:00+00:00,-0.55,22296.35,2020-04,savings
2020-04-15 00:00:00+00:00,-25.77,22322.12,2020-04,shopping
2020-04-15 00:00:00+00:00,-0.46,22322.58,2020-04,savings
2020-04-15 00:00:00+00:00,2.07,22320.51,2020-04,shopping
2020-04-15 00:00:00+00:00,-12.63,22333.14,2020-04,shopping
2020-04-14 00:00:00+00:00,-2.0,22335.14,2020-04,entertainment
2020-04-14 00:00:00+00:00,-14.89,22350.03,2020-04,entertainment
2020-04-14 00:00:00+00:00,-1.4,22351.43,2020-04,entertainment
2020-04-12 00:00:00+00:00,-0.37,22351.8,2020-04,savings
2020-04-12 00:00:00+00:00,-23.11,22374.91,2020-04,transport
2020-04-11 00:00:00+00:00,47.12,22327.79,2020-04,finances
2020-04-11 00:00:00+00:00,38.3,22289.49,2020-04,transfer
2020-04-11 00:00:00+00:00,22.42,22267.07,2020-04,taxes
2020-04-11 00:00:00+00:00,-17.0,22284.07,2020-04,holidays
2020-04-10 00:00:00+00:00,-36.97,22321.04,2020-04,finances
2020-04-10 00:00:00+00:00,-5.0,22326.04,2020-04,groceries / food spend
2020-04-10 00:00:00+00:00,40.0,22286.04,2020-04,transfer
2020-04-10 00:00:00+00:00,54.45,22231.59,2020-04,finances
2020-04-10 00:00:00+00:00,-40.25,22271.84,2020-04,transfer
2020-04-10 00:00:00+00:00,-22.64,22294.48,2020-04,bills and utilities
2020-04-09 00:00:00+00:00,-23.62,22318.1,2020-04,transport
2020-04-09 00:00:00+00:00,-20.56,22338.66,2020-04,taxes
2020-04-09 00:00:00+00:00,-0.46,22339.12,2020-04,savings
2020-04-09 00:00:00+00:00,70.0,22269.12,2020-04,transfer
2020-04-08 00:00:00+00:00,-0.01,22269.13,2020-04,savings
2020-04-08 00:00:00+00:00,22.35,22246.78,2020-04,taxes
2020-04-08 00:00:00+00:00,-15.59,22262.37,2020-04,fees and charges
2020-04-08 00:00:00+00:00,-100.0,22362.37,2020-04,rent
2020-04-08 00:00:00+00:00,-10.0,22372.37,2020-04,entertainment
2020-04-08 00:00:00+00:00,-0.69,22373.06,2020-04,savings
2020-04-08 00:00:00+00:00,-0.87,22373.93,2020-04,savings
2020-04-08 00:00:00+00:00,-24.31,22398.24,2020-04,groceries / food spend
2020-04-07 00:00:00+00:00,-71.97,22470.21,2020-04,bills and utilities
2020-04-07 00:00:00+00:00,-1.3,22471.51,2020-04,savings
2020-04-07 00:00:00+00:00,-70.0,22541.51,2020-04,transfer
2020-04-06 00:00:00+00:00,-28.25,22569.76,2020-04,bills and utilities
2020-04-06 00:00:00+00:00,22.18,22547.58,2020-04,taxes
2020-04-06 00:00:00+00:00,-15.94,22563.52,2020-04,groceries / food spend
2020-04-06 00:00:00+00:00,-43.01,22606.53,2020-04,bills and utilities
2020-04-06 00:00:00+00:00,-9.71,22616.24,2020-04,home and garden
2020-04-06 00:00:00+00:00,338.33,22277.91,2020-04,taxes
2020-04-06 00:00:00+00:00,197.41,22080.5,2020-04,transfer
2020-04-06 00:00:00+00:00,61.89,22018.61,2020-04,transfer
2020-04-06 00:00:00+00:00,-0.01,22018.62,2020-04,savings
2020-04-06 00:00:00+00:00,-5.0,22023.62,2020-04,shopping
2020-04-05 00:00:00+00:00,-60.0,22083.62,2020-04,transfer
2020-04-05 00:00:00+00:00,-1.89,22085.51,2020-04,savings
2020-04-05 00:00:00+00:00,-5.79,22091.3,2020-04,finances
2020-04-05 00:00:00+00:00,-2.88,22094.18,2020-04,shopping
2020-04-05 00:00:00+00:00,-11.52,22105.7,2020-04,transfer
2020-04-05 00:00:00+00:00,-16.54,22122.24,2020-04,finances
2020-04-05 00:00:00+00:00,-5.63,22127.87,2020-04,groceries / food spend
2020-04-05 00:00:00+00:00,-20.0,22147.87,2020-04,shopping
2020-04-04 00:00:00+00:00,0.11,22147.76,2020-04,transfer
2020-04-04 00:00:00+00:00,122.28,22025.48,2020-04,transfer
2020-04-04 00:00:00+00:00,59.17,21966.31,2020-04,transfer
2020-04-04 00:00:00+00:00,-16.35,21982.66,2020-04,transfer
2020-04-04 00:00:00+00:00,-5.0,21987.66,2020-04,shopping
2020-04-04 00:00:00+00:00,-3.07,21990.73,2020-04,finances
2020-04-04 00:00:00+00:00,-134.59,22125.32,2020-04,transfer
2020-04-04 00:00:00+00:00,97.53,22027.79,2020-04,transfer
2020-04-04 00:00:00+00:00,-5.96,22033.75,2020-04,business services
2020-04-04 00:00:00+00:00,26.41,22007.34,2020-04,transfer
2020-04-04 00:00:00+00:00,-130.0,22137.34,2020-04,rent
2020-04-03 00:00:00+00:00,0.89,22136.45,2020-04,transfer
2020-04-03 00:00:00+00:00,-0.42,22136.87,2020-04,savings
2020-04-03 00:00:00+00:00,101.79,22035.08,2020-04,transfer
2020-04-03 00:00:00+00:00,3.71,22031.37,2020-04,transfer
2020-04-03 00:00:00+00:00,-23.11,22054.48,2020-04,transport
2020-04-03 00:00:00+00:00,35.49,22018.99,2020-04,entertainment
2020-04-03 00:00:00+00:00,-0.01,22019.0,2020-04,savings
2020-04-03 00:00:00+00:00,-4.57,22023.57,2020-04,entertainment
2020-04-03 00:00:00+00:00,-30.0,22053.57,2020-04,shopping
2020-04-03 00:00:00+00:00,50.6,22002.97,2020-04,transfer
2020-04-03 00:00:00+00:00,-35.41,22038.38,2020-04,transfer
2020-04-03 00:00:00+00:00,-5.0,22043.38,2020-04,groceries / food spend
2020-04-02 00:00:00+00:00,15.88,22027.5,2020-04,transfer
2020-04-02 00:00:00+00:00,-30.0,22057.5,2020-04,transfer
2020-04-02 00:00:00+00:00,13.15,22044.35,2020-04,transfer
2020-04-02 00:00:00+00:00,-0.52,22044.87,2020-04,savings
2020-04-01 00:00:00+00:00,-46.82,22091.69,2020-04,bills and utilities
2020-04-01 00:00:00+00:00,-0.01,22091.7,2020-04,fees and charges
2020-04-01 00:00:00+00:00,-227.0,22318.7,2020-04,transfer
2020-04-01 00:00:00+00:00,-14.84,22333.54,2020-04,groceries / food spend
2020-04-01 00:00:00+00:00,-0.01,22333.55,2020-04,finances
2020-04-01 00:00:00+00:00,-0.01,22333.56,2020-04,shopping
2020-04-01 00:00:00+00:00,-0.01,22333.57,2020-04,shopping
2020-04-01 00:00:00+00:00,-0.01,22333.58,2020-04,groceries / food spend
2020-04-01 00:00:00+00:00,-0.02,22333.6,2020-04,groceries / food spend
2020-04-01 00:00:00+00:00,-0.01,22333.61,2020-04,groceries / food spend
2020-04-01 00:00:00+00:00,-0.01,22333.62,2020-04,groceries / food spend
2020-04-01 00:00:00+00:00,-0.01,22333.63,2020-04,transport
2020-04-01 00:00:00+00:00,-200.0,22533.63,2020-04,restaurants / eating out / delivery
2020-04-01 00:00:00+00:00,-0.01,22533.64,2020-04,home and garden
2020-04-01 00:00:00+00:00,-0.0,22533.64,2020-04,fees and charges
2020-04-01 00:00:00+00:00,-0.01,22533.65,2020-04,transport
2020-04-01 00:00:00+00:00,-0.0,22533.65,2020-04,entertainment
2020-04-01 00:00:00+00:00,-0.01,22533.66,2020-04,fees and charges
2020-04-01 00:00:00+00:00,-23.99,22557.65,2020-04,groceries / food spend
2020-04-01 00:00:00+00:00,-20.91,22578.56,2020-04,transfer
2020-04-01 00:00:00+00:00,-9.83,22588.39,2020-04,business services
2020-04-01 00:00:00+00:00,-10.0,22598.39,2020-04,bills and utilities
2020-04-01 00:00:00+00:00,-7.7,22606.09,2020-04,finances
2020-04-01 00:00:00+00:00,-10.0,22616.09,2020-04,finances
2020-04-01 00:00:00+00:00,-10.6,22626.69,2020-04,bills and utilities
2020-03-28 00:00:00+00:00,144.37,22482.32,2020-03,transfer
2020-03-28 00:00:00+00:00,-36.59,22518.91,2020-03,shopping
2020-03-28 00:00:00+00:00,40.0,22478.91,2020-03,transfer
2020-03-28 00:00:00+00:00,-39.57,22518.48,2020-03,transfer
2020-03-28 00:00:00+00:00,22.1,22496.38,2020-03,taxes
2020-03-27 00:00:00+00:00,-7.93,22504.31,2020-03,transfer
2020-03-27 00:00:00+00:00,57.42,22446.89,2020-03,transfer
2020-03-27 00:00:00+00:00,15.86,22431.03,2020-03,transfer
2020-03-27 00:00:00+00:00,-20.56,22451.59,2020-03,transport
2020-03-27 00:00:00+00:00,-2.87,22454.46,2020-03,finances
2020-03-27 00:00:00+00:00,-23.62,22478.08,2020-03,groceries / food spend
2020-03-27 00:00:00+00:00,-7.56,22485.64,2020-03,shopping
2020-03-25 00:00:00+00:00,70.0,22415.64,2020-03,transfer
2020-03-25 00:00:00+00:00,-23.76,22439.4,2020-03,entertainment
2020-03-25 00:00:00+00:00,-10.0,22449.4,2020-03,transfer
2020-03-25 00:00:00+00:00,-0.46,22449.86,2020-03,savings
2020-03-25 00:00:00+00:00,-36.59,22486.45,2020-03,shopping
2020-03-25 00:00:00+00:00,-0.44,22486.89,2020-03,savings
2020-03-25 00:00:00+00:00,-0.99,22487.88,2020-03,entertainment
2020-03-23 00:00:00+00:00,-30.0,22517.88,2020-03,finances
2020-03-23 00:00:00+00:00,57.85,22460.03,2020-03,transfer
2020-03-23 00:00:00+00:00,-116.54,22576.57,2020-03,transfer
2020-03-23 00:00:00+00:00,-1.57,22578.14,2020-03,savings
2020-03-23 00:00:00+00:00,-31.63,22609.77,2020-03,transfer
2020-03-22 00:00:00+00:00,-3.13,22612.9,2020-03,shopping
2020-03-22 00:00:00+00:00,-0.01,22612.91,2020-03,savings
2020-03-22 00:00:00+00:00,-37.71,22650.62,2020-03,bills and utilities
2020-03-22 00:00:00+00:00,-36.59,22687.21,2020-03,shopping
2020-03-22 00:00:00+00:00,-47.51,22734.72,2020-03,finances
2020-03-20 00:00:00+00:00,-150.0,22884.72,2020-03,rent
2020-03-20 00:00:00+00:00,22.42,22862.3,2020-03,taxes
2020-03-20 00:00:00+00:00,-550.0,23412.3,2020-03,business services
2020-03-20 00:00:00+00:00,357.23,23055.07,2020-03,taxes
2020-03-19 00:00:00+00:00,-10.55,23065.62,2020-03,shopping
2020-03-19 00:00:00+00:00,1450.42,21615.2,2020-03,salary
2020-03-18 00:00:00+00:00,82.21,21532.99,2020-03,finances
2020-03-17 00:00:00+00:00,131.74,21401.25,2020-03,transfer
2020-03-17 00:00:00+00:00,-12.52,21413.77,2020-03,finances
2020-03-17 00:00:00+00:00,-40.0,21453.77,2020-03,finances
2020-03-17 00:00:00+00:00,-20.0,21473.77,2020-03,transport
2020-03-17 00:00:00+00:00,-0.69,21474.46,2020-03,savings
2020-03-17 00:00:00+00:00,0.5,21473.96,2020-03,groceries / food spend
2020-03-15 00:00:00+00:00,-32.0,21505.96,2020-03,groceries / food spend
2020-03-15 00:00:00+00:00,-0.51,21506.47,2020-03,savings
2020-03-15 00:00:00+00:00,-15.45,21521.92,2020-03,shopping
2020-03-15 00:00:00+00:00,-0.53,21522.45,2020-03,savings
2020-03-15 00:00:00+00:00,-3.59,21526.04,2020-03,shopping
2020-03-15 00:00:00+00:00,-10.0,21536.04,2020-03,shopping
2020-03-14 00:00:00+00:00,-2.0,21538.04,2020-03,entertainment
2020-03-14 00:00:00+00:00,-5.9,21543.94,2020-03,entertainment
2020-03-14 00:00:00+00:00,61.46,21482.48,2020-03,entertainment
2020-03-12 00:00:00+00:00,-0.41,21482.89,2020-03,savings
2020-03-12 00:00:00+00:00,-23.11,21506.0,2020-03,transport
2020-03-11 00:00:00+00:00,50.0,21456.0,2020-03,finances
2020-03-11 00:00:00+00:00,50.0,21406.0,2020-03,transfer
2020-03-11 00:00:00+00:00,22.99,21383.01,2020-03,taxes
2020-03-11 00:00:00+00:00,-17.0,21400.01,2020-03,holidays
2020-03-10 00:00:00+00:00,-40.0,21440.01,2020-03,finances
2020-03-10 00:00:00+00:00,-5.0,21445.01,2020-03,groceries / food spend
2020-03-10 00:00:00+00:00,40.0,21405.01,2020-03,transfer
2020-03-10 00:00:00+00:00,70.34,21334.67,2020-03,finances
2020-03-10 00:00:00+00:00,-30.0,21364.67,2020-03,transfer
2020-03-10 00:00:00+00:00,-24.5,21389.17,2020-03,bills and utilities
2020-03-09 00:00:00+00:00,-22.23,21411.4,2020-03,transport
2020-03-09 00:00:00+00:00,-20.56,21431.96,2020-03,taxes
2020-03-09 00:00:00+00:00,-0.39,21432.35,2020-03,savings
2020-03-09 00:00:00+00:00,49.8,21382.55,2020-03,transfer
2020-03-08 00:00:00+00:00,-0.01,21382.56,2020-03,savings
2020-03-08 00:00:00+00:00,23.57,21358.99,2020-03,taxes
2020-03-08 00:00:00+00:00,-14.99,21373.98,2020-03,fees and charges
2020-03-08 00:00:00+00:00,-100.0,21473.98,2020-03,rent
2020-03-08 00:00:00+00:00,-10.0,21483.98,2020-03,entertainment
2020-03-08 00:00:00+00:00,-0.73,21484.71,2020-03,savings
2020-03-08 00:00:00+00:00,-0.9,21485.61,2020-03,savings
2020-03-08 00:00:00+00:00,-40.16,21525.77,2020-03,groceries / food spend
2020-03-07 00:00:00+00:00,-82.37,21608.14,2020-03,bills and utilities
2020-03-07 00:00:00+00:00,-1.15,21609.29,2020-03,savings
2020-03-07 00:00:00+00:00,-70.0,21679.29,2020-03,transfer
2020-03-06 00:00:00+00:00,-26.12,21705.41,2020-03,bills and utilities
2020-03-06 00:00:00+00:00,22.42,21682.99,2020-03,taxes
2020-03-06 00:00:00+00:00,-12.89,21695.88,2020-03,groceries / food spend
2020-03-06 00:00:00+00:00,-47.93,21743.81,2020-03,bills and utilities
2020-03-06 00:00:00+00:00,-10.35,21754.16,2020-03,home and garden
2020-03-06 00:00:00+00:00,346.35,21407.81,2020-03,taxes
2020-03-06 00:00:00+00:00,178.77,21229.04,2020-03,transfer
2020-03-06 00:00:00+00:00,61.89,21167.15,2020-03,transfer
2020-03-06 00:00:00+00:00,-0.01,21167.16,2020-03,savings
2020-03-06 00:00:00+00:00,-5.0,21172.16,2020-03,shopping
2020-03-05 00:00:00+00:00,-62.01,21234.17,2020-03,transfer
2020-03-05 00:00:00+00:00,-1.69,21235.86,2020-03,savings
2020-03-05 00:00:00+00:00,-5.76,21241.62,2020-03,finances
2020-03-05 00:00:00+00:00,-4.98,21246.6,2020-03,shopping
2020-03-05 00:00:00+00:00,-18.96,21265.56,2020-03,transfer
2020-03-05 00:00:00+00:00,-14.32,21279.88,2020-03,finances
2020-03-05 00:00:00+00:00,-4.57,21284.45,2020-03,groceries / food spend
2020-03-05 00:00:00+00:00,-27.4,21311.85,2020-03,shopping
2020-03-04 00:00:00+00:00,13.44,21298.41,2020-03,transfer
2020-03-04 00:00:00+00:00,70.0,21228.41,2020-03,transfer
2020-03-04 00:00:00+00:00,59.17,21169.24,2020-03,transfer
2020-03-04 00:00:00+00:00,-20.0,21189.24,2020-03,transfer
2020-03-04 00:00:00+00:00,-11.48,21200.72,2020-03,shopping
2020-03-04 00:00:00+00:00,-3.07,21203.79,2020-03,finances
2020-03-04 00:00:00+00:00,-63.77,21267.56,2020-03,transfer
2020-03-04 00:00:00+00:00,100.0,21167.56,2020-03,transfer
2020-03-04 00:00:00+00:00,-3.59,21171.15,2020-03,business services
2020-03-04 00:00:00+00:00,28.47,21142.68,2020-03,transfer
2020-03-04 00:00:00+00:00,-130.0,21272.68,2020-03,rent
2020-03-03 00:00:00+00:00,1.38,21271.3,2020-03,transfer
2020-03-03 00:00:00+00:00,-0.36,21271.66,2020-03,savings
2020-03-03 00:00:00+00:00,187.6,21084.06,2020-03,transfer
2020-03-03 00:00:00+00:00,7.0,21077.06,2020-03,transfer
2020-03-03 00:00:00+00:00,-23.11,21100.17,2020-03,transport
2020-03-03 00:00:00+00:00,35.49,21064.68,2020-03,entertainment
2020-03-03 00:00:00+00:00,-0.01,21064.69,2020-03,savings
2020-03-03 00:00:00+00:00,-3.76,21068.45,2020-03,entertainment
2020-03-03 00:00:00+00:00,-65.3,21133.75,2020-03,shopping
2020-03-03 00:00:00+00:00,37.6,21096.15,2020-03,transfer
2020-03-03 00:00:00+00:00,-49.68,21145.83,2020-03,transfer
2020-03-03 00:00:00+00:00,-5.0,21150.83,2020-03,groceries / food spend
2020-03-02 00:00:00+00:00,35.03,21115.8,2020-03,transfer
2020-03-02 00:00:00+00:00,-30.0,21145.8,2020-03,transfer
2020-03-02 00:00:00+00:00,16.1,21129.7,2020-03,transfer
2020-03-02 00:00:00+00:00,-0.62,21130.32,2020-03,savings
2020-03-01 00:00:00+00:00,-46.82,21177.14,2020-03,bills and utilities
2020-03-01 00:00:00+00:00,-0.01,21177.15,2020-03,fees and charges
2020-03-01 00:00:00+00:00,-86.28,21263.43,2020-03,transfer
2020-03-01 00:00:00+00:00,-39.99,21303.42,2020-03,groceries / food spend
2020-03-01 00:00:00+00:00,-0.01,21303.43,2020-03,finances
2020-03-01 00:00:00+00:00,-0.01,21303.44,2020-03,shopping
2020-03-01 00:00:00+00:00,-0.01,21303.45,2020-03,shopping
2020-03-01 00:00:00+00:00,-0.02,21303.47,2020-03,groceries / food spend
2020-03-01 00:00:00+00:00,-0.01,21303.48,2020-03,groceries / food spend
2020-03-01 00:00:00+00:00,-0.02,21303.5,2020-03,groceries / food spend
2020-03-01 00:00:00+00:00,-0.01,21303.51,2020-03,groceries / food spend
2020-03-01 00:00:00+00:00,-0.01,21303.52,2020-03,transport
2020-03-01 00:00:00+00:00,-200.0,21503.52,2020-03,restaurants / eating out / delivery
2020-03-01 00:00:00+00:00,-0.01,21503.53,2020-03,home and garden
2020-03-01 00:00:00+00:00,-0.01,21503.54,2020-03,fees and charges
2020-03-01 00:00:00+00:00,-0.01,21503.55,2020-03,transport
2020-03-01 00:00:00+00:00,-0.01,21503.56,2020-03,entertainment
2020-03-01 00:00:00+00:00,-0.01,21503.57,2020-03,fees and charges
2020-03-01 00:00:00+00:00,-15.9,21519.47,2020-03,groceries / food spend
2020-03-01 00:00:00+00:00,-20.91,21540.38,2020-03,transfer
2020-03-01 00:00:00+00:00,-10.0,21550.38,2020-03,business services
2020-03-01 00:00:00+00:00,-10.75,21561.13,2020-03,bills and utilities
2020-03-01 00:00:00+00:00,-9.11,21570.24,2020-03,finances
2020-03-01 00:00:00+00:00,-7.98,21578.22,2020-03,finances
2020-03-01 00:00:00+00:00,-9.63,21587.85,2020-03,bills and utilities
2020-02-28 00:00:00+00:00,420.0,21167.85,2020-02,transfer
2020-02-28 00:00:00+00:00,-33.32,21201.17,2020-02,shopping
2020-02-28 00:00:00+00:00,40.0,21161.17,2020-02,transfer
2020-02-28 00:00:00+00:00,-32.72,21193.89,2020-02,transfer
2020-02-28 00:00:00+00:00,22.42,21171.47,2020-02,taxes
2020-02-27 00:00:00+00:00,-5.23,21176.7,2020-02,transfer
2020-02-27 00:00:00+00:00,66.54,21110.16,2020-02,transfer
2020-02-27 00:00:00+00:00,20.25,21089.91,2020-02,transfer
2020-02-27 00:00:00+00:00,-29.23,21119.14,2020-02,transport
2020-02-27 00:00:00+00:00,-2.99,21122.13,2020-02,finances
2020-02-27 00:00:00+00:00,-23.62,21145.75,2020-02,groceries / food spend
2020-02-27 00:00:00+00:00,-12.45,21158.2,2020-02,shopping
2020-02-25 00:00:00+00:00,110.05,21048.15,2020-02,transfer
2020-02-25 00:00:00+00:00,-24.5,21072.65,2020-02,entertainment
2020-02-25 00:00:00+00:00,-14.83,21087.48,2020-02,transfer
2020-02-25 00:00:00+00:00,-0.41,21087.89,2020-02,savings
2020-02-25 00:00:00+00:00,-36.59,21124.48,2020-02,shopping
2020-02-25 00:00:00+00:00,-0.5,21124.98,2020-02,savings
2020-02-25 00:00:00+00:00,-10.5,21135.48,2020-02,entertainment
2020-02-23 00:00:00+00:00,-30.0,21165.48,2020-02,finances
2020-02-23 00:00:00+00:00,21.8,21143.68,2020-02,transfer
2020-02-23 00:00:00+00:00,-100.0,21243.68,2020-02,transfer
2020-02-23 00:00:00+00:00,-1.57,21245.25,2020-02,savings
2020-02-23 00:00:00+00:00,-20.0,21265.25,2020-02,transfer
2020-02-22 00:00:00+00:00,-13.73,21278.98,2020-02,shopping
2020-02-22 00:00:00+00:00,-0.01,21278.99,2020-02,savings
2020-02-22 00:00:00+00:00,-37.7,21316.69,2020-02,bills and utilities
2020-02-22 00:00:00+00:00,-36.59,21353.28,2020-02,shopping
2020-02-22 00:00:00+00:00,-40.51,21393.79,2020-02,finances
2020-02-20 00:00:00+00:00,-150.0,21543.79,2020-02,rent
2020-02-20 00:00:00+00:00,22.42,21521.37,2020-02,taxes
2020-02-20 00:00:00+00:00,-550.0,22071.37,2020-02,business services
2020-02-20 00:00:00+00:00,354.31,21717.06,2020-02,taxes
2020-02-19 00:00:00+00:00,-5.4,21722.46,2020-02,shopping
2020-02-19 00:00:00+00:00,1450.42,20272.04,2020-02,salary
2020-02-18 00:00:00+00:00,92.33,20179.71,2020-02,finances
2020-02-17 00:00:00+00:00,106.45,20073.26,2020-02,transfer
2020-02-17 00:00:00+00:00,-12.73,20085.99,2020-02,finances
2020-02-17 00:00:00+00:00,-40.0,20125.99,2020-02,finances
2020-02-17 00:00:00+00:00,-13.91,20139.9,2020-02,transport
2020-02-17 00:00:00+00:00,-0.63,20140.53,2020-02,savings
2020-02-17 00:00:00+00:00,-6.37,20146.9,2020-02,groceries / food spend
2020-02-15 00:00:00+00:00,-32.0,20178.9,2020-02,groceries / food spend
2020-02-15 00:00:00+00:00,-0.61,20179.51,2020-02,savings
2020-02-15 00:00:00+00:00,-4.62,20184.13,2020-02,shopping
2020-02-15 00:00:00+00:00,-0.5,20184.63,2020-02,savings
2020-02-15 00:00:00+00:00,-3.21,20187.84,2020-02,shopping
2020-02-15 00:00:00+00:00,-10.0,20197.84,2020-02,shopping
2020-02-14 00:00:00+00:00,-2.0,20199.84,2020-02,entertainment
2020-02-14 00:00:00+00:00,-6.36,20206.2,2020-02,entertainment
2020-02-14 00:00:00+00:00,43.5,20162.7,2020-02,entertainment
2020-02-12 00:00:00+00:00,-0.41,20163.11,2020-02,savings
2020-02-12 00:00:00+00:00,-23.11,20186.22,2020-02,transport
2020-02-11 00:00:00+00:00,42.43,20143.79,2020-02,finances
2020-02-11 00:00:00+00:00,50.0,20093.79,2020-02,transfer
2020-02-11 00:00:00+00:00,23.57,20070.22,2020-02,taxes
2020-02-11 00:00:00+00:00,-17.0,20087.22,2020-02,holidays
2020-02-10 00:00:00+00:00,-33.43,20120.65,2020-02,finances
2020-02-10 00:00:00+00:00,-8.09,20128.74,2020-02,groceries / food spend
2020-02-10 00:00:00+00:00,40.0,20088.74,2020-02,transfer
2020-02-10 00:00:00+00:00,42.05,20046.69,2020-02,finances
2020-02-10 00:00:00+00:00,-30.0,20076.69,2020-02,transfer
2020-02-10 00:00:00+00:00,-21.77,20098.46,2020-02,bills and utilities
2020-02-09 00:00:00+00:00,-23.62,20122.08,2020-02,transport
2020-02-09 00:00:00+00:00,-19.07,20141.15,2020-02,taxes
2020-02-09 00:00:00+00:00,-0.41,20141.56,2020-02,savings
2020-02-09 00:00:00+00:00,75.08,20066.48,2020-02,transfer
2020-02-08 00:00:00+00:00,-0.01,20066.49,2020-02,savings
2020-02-08 00:00:00+00:00,21.85,20044.64,2020-02,taxes
2020-02-08 00:00:00+00:00,-14.99,20059.63,2020-02,fees and charges
2020-02-08 00:00:00+00:00,-100.0,20159.63,2020-02,rent
2020-02-08 00:00:00+00:00,3.51,20156.12,2020-02,entertainment
2020-02-08 00:00:00+00:00,-0.77,20156.89,2020-02,savings
2020-02-08 00:00:00+00:00,-1.04,20157.93,2020-02,savings
2020-02-08 00:00:00+00:00,-30.99,20188.92,2020-02,groceries / food spend
2020-02-07 00:00:00+00:00,-79.44,20268.36,2020-02,bills and utilities
2020-02-07 00:00:00+00:00,-1.33,20269.69,2020-02,savings
2020-02-07 00:00:00+00:00,-70.0,20339.69,2020-02,transfer
2020-02-06 00:00:00+00:00,-28.25,20367.94,2020-02,bills and utilities
2020-02-06 00:00:00+00:00,22.42,20345.52,2020-02,taxes
2020-02-06 00:00:00+00:00,-12.89,20358.41,2020-02,groceries / food spend
2020-02-06 00:00:00+00:00,-50.0,20408.41,2020-02,bills and utilities
2020-02-06 00:00:00+00:00,-9.71,20418.12,2020-02,home and garden
2020-02-06 00:00:00+00:00,355.95,20062.17,2020-02,taxes
2020-02-06 00:00:00+00:00,137.6,19924.57,2020-02,transfer
2020-02-06 00:00:00+00:00,79.03,19845.54,2020-02,transfer
2020-02-06 00:00:00+00:00,-0.01,19845.55,2020-02,savings
2020-02-06 00:00:00+00:00,-5.0,19850.55,2020-02,shopping
2020-02-05 00:00:00+00:00,-2.46,19853.01,2020-02,transfer
2020-02-05 00:00:00+00:00,-2.23,19855.24,2020-02,savings
2020-02-05 00:00:00+00:00,-5.55,19860.79,2020-02,finances
2020-02-05 00:00:00+00:00,-11.24,19872.03,2020-02,shopping
2020-02-05 00:00:00+00:00,-23.15,19895.18,2020-02,transfer
2020-02-05 00:00:00+00:00,-12.73,19907.91,2020-02,finances
2020-02-05 00:00:00+00:00,-6.37,19914.28,2020-02,groceries / food spend
2020-02-05 00:00:00+00:00,-1.54,19915.82,2020-02,shopping
2020-02-04 00:00:00+00:00,6.85,19908.97,2020-02,transfer
2020-02-04 00:00:00+00:00,70.0,19838.97,2020-02,transfer
2020-02-04 00:00:00+00:00,59.17,19779.8,2020-02,transfer
2020-02-04 00:00:00+00:00,-20.0,19799.8,2020-02,transfer
2020-02-04 00:00:00+00:00,-5.0,19804.8,2020-02,shopping
2020-02-04 00:00:00+00:00,-2.6,19807.4,2020-02,finances
2020-02-04 00:00:00+00:00,-131.31,19938.71,2020-02,transfer
2020-02-04 00:00:00+00:00,90.73,19847.98,2020-02,transfer
2020-02-04 00:00:00+00:00,-3.59,19851.57,2020-02,business services
2020-02-04 00:00:00+00:00,15.65,19835.92,2020-02,transfer
2020-02-04 00:00:00+00:00,-130.0,19965.92,2020-02,rent
2020-02-03 00:00:00+00:00,1.34,19964.58,2020-02,transfer
2020-02-03 00:00:00+00:00,-0.41,19964.99,2020-02,savings
2020-02-03 00:00:00+00:00,130.0,19834.99,2020-02,transfer
2020-02-03 00:00:00+00:00,7.0,19827.99,2020-02,transfer
2020-02-03 00:00:00+00:00,-23.11,19851.1,2020-02,transport
2020-02-03 00:00:00+00:00,8.47,19842.63,2020-02,entertainment
2020-02-03 00:00:00+00:00,-0.01,19842.64,2020-02,savings
2020-02-03 00:00:00+00:00,-3.12,19845.76,2020-02,entertainment
2020-02-03 00:00:00+00:00,-23.04,19868.8,2020-02,shopping
2020-02-03 00:00:00+00:00,40.0,19828.8,2020-02,transfer
2020-02-03 00:00:00+00:00,-23.51,19852.31,2020-02,transfer
2020-02-03 00:00:00+00:00,-1.72,19854.03,2020-02,groceries / food spend
2020-02-02 00:00:00+00:00,30.0,19824.03,2020-02,transfer
2020-02-02 00:00:00+00:00,-42.65,19866.68,2020-02,transfer
2020-02-02 00:00:00+00:00,6.64,19860.04,2020-02,transfer
2020-02-02 00:00:00+00:00,-0.56,19860.6,2020-02,savings
2020-02-01 00:00:00+00:00,-46.82,19907.42,2020-02,bills and utilities
2020-02-01 00:00:00+00:00,-0.01,19907.43,2020-02,fees and charges
2020-02-01 00:00:00+00:00,-227.0,20134.43,2020-02,transfer
2020-02-01 00:00:00+00:00,-39.99,20174.42,2020-02,groceries / food spend
2020-02-01 00:00:00+00:00,-0.01,20174.43,2020-02,finances
2020-02-01 00:00:00+00:00,-0.01,20174.44,2020-02,shopping
2020-02-01 00:00:00+00:00,-0.01,20174.45,2020-02,shopping
2020-02-01 00:00:00+00:00,-0.01,20174.46,2020-02,groceries / food spend
2020-02-01 00:00:00+00:00,-0.01,20174.47,2020-02,groceries / food spend
2020-02-01 00:00:00+00:00,-0.02,20174.49,2020-02,groceries / food spend
2020-02-01 00:00:00+00:00,-0.02,20174.51,2020-02,groceries / food spend
2020-02-01 00:00:00+00:00,-0.01,20174.52,2020-02,transport
2020-02-01 00:00:00+00:00,-393.18,20567.7,2020-02,restaurants / eating out / delivery
2020-02-01 00:00:00+00:00,-0.01,20567.71,2020-02,home and garden
2020-02-01 00:00:00+00:00,-0.01,20567.72,2020-02,fees and charges
2020-02-01 00:00:00+00:00,-0.01,20567.73,2020-02,transport
2020-02-01 00:00:00+00:00,-0.02,20567.75,2020-02,entertainment
2020-02-01 00:00:00+00:00,-0.01,20567.76,2020-02,fees and charges
2020-02-01 00:00:00+00:00,-23.99,20591.75,2020-02,groceries / food spend
2020-02-01 00:00:00+00:00,-20.91,20612.66,2020-02,transfer
2020-02-01 00:00:00+00:00,-6.41,20619.07,2020-02,business services
2020-02-01 00:00:00+00:00,-10.0,20629.07,2020-02,bills and utilities
2020-02-01 00:00:00+00:00,-12.49,20641.56,2020-02,finances
2020-02-01 00:00:00+00:00,-7.21,20648.77,2020-02,finances
2020-02-01 00:00:00+00:00,-10.48,20659.25,2020-02,bills and utilities
2020-01-28 00:00:00+00:00,98.18,20561.07,2020-01,transfer
2020-01-28 00:00:00+00:00,-36.59,20597.66,2020-01,shopping
2020-01-28 00:00:00+00:00,48.37,20549.29,2020-01,transfer
2020-01-28 00:00:00+00:00,-32.72,20582.01,2020-01,transfer
2020-01-28 00:00:00+00:00,22.42,20559.59,2020-01,taxes
2020-01-27 00:00:00+00:00,-4.67,20564.26,2020-01,transfer
2020-01-27 00:00:00+00:00,50.59,20513.67,2020-01,transfer
2020-01-27 00:00:00+00:00,15.86,20497.81,2020-01,transfer
2020-01-27 00:00:00+00:00,-20.56,20518.37,2020-01,transport
2020-01-27 00:00:00+00:00,-2.99,20521.36,2020-01,finances
2020-01-27 00:00:00+00:00,-23.62,20544.98,2020-01,groceries / food spend
2020-01-27 00:00:00+00:00,-7.56,20552.54,2020-01,shopping
2020-01-25 00:00:00+00:00,91.13,20461.41,2020-01,transfer
2020-01-25 00:00:00+00:00,-24.5,20485.91,2020-01,entertainment
2020-01-25 00:00:00+00:00,-5.49,20491.4,2020-01,transfer
2020-01-25 00:00:00+00:00,-0.41,20491.81,2020-01,savings
2020-01-25 00:00:00+00:00,-48.89,20540.7,2020-01,shopping
2020-01-25 00:00:00+00:00,-0.53,20541.23,2020-01,savings
2020-01-25 00:00:00+00:00,-10.5,20551.73,2020-01,entertainment
2020-01-23 00:00:00+00:00,-25.98,20577.71,2020-01,finances
2020-01-23 00:00:00+00:00,32.5,20545.21,2020-01,transfer
2020-01-23 00:00:00+00:00,-145.88,20691.09,2020-01,transfer
2020-01-23 00:00:00+00:00,-1.57,20692.66,2020-01,savings
2020-01-23 00:00:00+00:00,-13.05,20705.71,2020-01,transfer
2020-01-22 00:00:00+00:00,-5.0,20710.71,2020-01,shopping
2020-01-22 00:00:00+00:00,-0.01,20710.72,2020-01,savings
2020-01-22 00:00:00+00:00,-40.84,20751.56,2020-01,bills and utilities
2020-01-22 00:00:00+00:00,-36.59,20788.15,2020-01,shopping
2020-01-22 00:00:00+00:00,-36.59,20824.74,2020-01,finances
2020-01-20 00:00:00+00:00,-150.0,20974.74,2020-01,rent
2020-01-20 00:00:00+00:00,20.66,20954.08,2020-01,taxes
2020-01-20 00:00:00+00:00,-698.67,21652.75,2020-01,business services
2020-01-20 00:00:00+00:00,356.69,21296.06,2020-01,taxes
2020-01-19 00:00:00+00:00,-7.99,21304.05,2020-01,shopping
2020-01-19 00:00:00+00:00,1450.42,19853.63,2020-01,salary
2020-01-18 00:00:00+00:00,82.21,19771.42,2020-01,finances
2020-01-17 00:00:00+00:00,137.6,19633.82,2020-01,transfer
2020-01-17 00:00:00+00:00,-12.73,19646.55,2020-01,finances
2020-01-17 00:00:00+00:00,-51.58,19698.13,2020-01,finances
2020-01-17 00:00:00+00:00,-20.0,19718.13,2020-01,transport
2020-01-17 00:00:00+00:00,-0.63,19718.76,2020-01,savings
2020-01-17 00:00:00+00:00,-6.37,19725.13,2020-01,groceries / food spend
2020-01-15 00:00:00+00:00,-42.39,19767.52,2020-01,groceries / food spend
2020-01-15 00:00:00+00:00,-0.59,19768.11,2020-01,savings
2020-01-15 00:00:00+00:00,-15.45,19783.56,2020-01,shopping
2020-01-15 00:00:00+00:00,-0.56,19784.12,2020-01,savings
2020-01-15 00:00:00+00:00,-6.97,19791.09,2020-01,shopping
2020-01-15 00:00:00+00:00,-10.0,19801.09,2020-01,shopping
2020-01-14 00:00:00+00:00,-4.04,19805.13,2020-01,entertainment
2020-01-14 00:00:00+00:00,-29.74,19834.87,2020-01,entertainment
2020-01-14 00:00:00+00:00,43.5,19791.37,2020-01,entertainment
2020-01-12 00:00:00+00:00,-0.41,19791.78,2020-01,savings
2020-01-12 00:00:00+00:00,-17.44,19809.22,2020-01,transport
2020-01-11 00:00:00+00:00,57.4,19751.82,2020-01,finances
2020-01-11 00:00:00+00:00,20.23,19731.59,2020-01,transfer
2020-01-11 00:00:00+00:00,22.42,19709.17,2020-01,taxes
2020-01-11 00:00:00+00:00,-19.41,19728.58,2020-01,holidays
2020-01-10 00:00:00+00:00,-40.0,19768.58,2020-01,finances
2020-01-10 00:00:00+00:00,-5.0,19773.58,2020-01,groceries / food spend
2020-01-10 00:00:00+00:00,40.0,19733.58,2020-01,transfer
2020-01-10 00:00:00+00:00,50.36,19683.22,2020-01,finances
2020-01-10 00:00:00+00:00,-7.14,19690.36,2020-01,transfer
2020-01-10 00:00:00+00:00,-25.76,19716.12,2020-01,bills and utilities
2020-01-09 00:00:00+00:00,-20.54,19736.66,2020-01,transport
2020-01-09 00:00:00+00:00,-20.56,19757.22,2020-01,taxes
2020-01-09 00:00:00+00:00,-0.43,19757.65,2020-01,savings
2020-01-09 00:00:00+00:00,95.81,19661.84,2020-01,transfer
2020-01-08 00:00:00+00:00,-0.01,19661.85,2020-01,savings
2020-01-08 00:00:00+00:00,22.85,19639.0,2020-01,taxes
2020-01-08 00:00:00+00:00,-25.77,19664.77,2020-01,fees and charges
2020-01-08 00:00:00+00:00,-100.0,19764.77,2020-01,rent
2020-01-08 00:00:00+00:00,-16.27,19781.04,2020-01,entertainment
2020-01-08 00:00:00+00:00,-0.69,19781.73,2020-01,savings
2020-01-08 00:00:00+00:00,-1.04,19782.77,2020-01,savings
2020-01-08 00:00:00+00:00,-24.31,19807.08,2020-01,groceries / food spend
2020-01-07 00:00:00+00:00,-77.76,19884.84,2020-01,bills and utilities
2020-01-07 00:00:00+00:00,-1.38,19886.22,2020-01,savings
2020-01-07 00:00:00+00:00,-49.93,19936.15,2020-01,transfer
2020-01-06 00:00:00+00:00,-29.84,19965.99,2020-01,bills and utilities
2020-01-06 00:00:00+00:00,22.69,19943.3,2020-01,taxes
2020-01-06 00:00:00+00:00,-12.89,19956.19,2020-01,groceries / food spend
2020-01-06 00:00:00+00:00,-50.0,20006.19,2020-01,bills and utilities
2020-01-06 00:00:00+00:00,-9.86,20016.05,2020-01,home and garden
2020-01-06 00:00:00+00:00,346.35,19669.7,2020-01,taxes
2020-01-06 00:00:00+00:00,33.82,19635.88,2020-01,transfer
2020-01-06 00:00:00+00:00,61.89,19573.99,2020-01,transfer
2020-01-06 00:00:00+00:00,-0.01,19574.0,2020-01,savings
2020-01-06 00:00:00+00:00,-3.08,19577.08,2020-01,shopping
2020-01-05 00:00:00+00:00,-60.0,19637.08,2020-01,transfer
2020-01-05 00:00:00+00:00,-1.89,19638.97,2020-01,savings
2020-01-05 00:00:00+00:00,-5.79,19644.76,2020-01,finances
2020-01-05 00:00:00+00:00,2.97,19641.79,2020-01,shopping
2020-01-05 00:00:00+00:00,-26.14,19667.93,2020-01,transfer
2020-01-05 00:00:00+00:00,-15.43,19683.36,2020-01,finances
2020-01-05 00:00:00+00:00,0.98,19682.38,2020-01,groceries / food spend
2020-01-05 00:00:00+00:00,-14.26,19696.64,2020-01,shopping
2020-01-04 00:00:00+00:00,10.0,19686.64,2020-01,transfer
2020-01-04 00:00:00+00:00,56.95,19629.69,2020-01,transfer
2020-01-04 00:00:00+00:00,30.97,19598.72,2020-01,transfer
2020-01-04 00:00:00+00:00,-20.18,19618.9,2020-01,transfer
2020-01-04 00:00:00+00:00,-5.0,19623.9,2020-01,shopping
2020-01-04 00:00:00+00:00,-2.87,19626.77,2020-01,finances
2020-01-04 00:00:00+00:00,-100.0,19726.77,2020-01,transfer
2020-01-04 00:00:00+00:00,62.41,19664.36,2020-01,transfer
2020-01-04 00:00:00+00:00,-3.59,19667.95,2020-01,business services
2020-01-04 00:00:00+00:00,12.55,19655.4,2020-01,transfer
2020-01-04 00:00:00+00:00,-130.0,19785.4,2020-01,rent
2020-01-03 00:00:00+00:00,0.89,19784.51,2020-01,transfer
2020-01-03 00:00:00+00:00,-0.41,19784.92,2020-01,savings
2020-01-03 00:00:00+00:00,91.88,19693.04,2020-01,transfer
2020-01-03 00:00:00+00:00,7.0,19686.04,2020-01,transfer
2020-01-03 00:00:00+00:00,-23.11,19709.15,2020-01,transport
2020-01-03 00:00:00+00:00,38.2,19670.95,2020-01,entertainment
2020-01-03 00:00:00+00:00,-0.01,19670.96,2020-01,savings
2020-01-03 00:00:00+00:00,-4.18,19675.14,2020-01,entertainment
2020-01-03 00:00:00+00:00,-30.0,19705.14,2020-01,shopping
2020-01-03 00:00:00+00:00,40.0,19665.14,2020-01,transfer
2020-01-03 00:00:00+00:00,-26.55,19691.69,2020-01,transfer
2020-01-03 00:00:00+00:00,-5.0,19696.69,2020-01,groceries / food spend
2020-01-02 00:00:00+00:00,30.0,19666.69,2020-01,transfer
2020-01-02 00:00:00+00:00,-41.02,19707.71,2020-01,transfer
2020-01-02 00:00:00+00:00,10.0,19697.71,2020-01,transfer
2020-01-02 00:00:00+00:00,-0.59,19698.3,2020-01,savings
2020-01-01 00:00:00+00:00,-44.23,19742.53,2020-01,bills and utilities
2020-01-01 00:00:00+00:00,-0.01,19742.54,2020-01,fees and charges
2020-01-01 00:00:00+00:00,22.99,19719.55,2020-01,transfer
2020-01-01 00:00:00+00:00,-39.99,19759.54,2020-01,groceries / food spend
2020-01-01 00:00:00+00:00,-0.01,19759.55,2020-01,finances
2020-01-01 00:00:00+00:00,-0.01,19759.56,2020-01,shopping
2020-01-01 00:00:00+00:00,-0.01,19759.57,2020-01,shopping
2020-01-01 00:00:00+00:00,-0.02,19759.59,2020-01,groceries / food spend
2020-01-01 00:00:00+00:00,-0.0,19759.59,2020-01,groceries / food spend
2020-01-01 00:00:00+00:00,-0.01,19759.6,2020-01,groceries / food spend
2020-01-01 00:00:00+00:00,-0.01,19759.61,2020-01,groceries / food spend
2020-01-01 00:00:00+00:00,-0.01,19759.62,2020-01,transport
2020-01-01 00:00:00+00:00,-253.66,20013.28,2020-01,restaurants / eating out / delivery
2020-01-01 00:00:00+00:00,0.01,20013.27,2020-01,home and garden
2020-01-01 00:00:00+00:00,-0.02,20013.29,2020-01,fees and charges
2020-01-01 00:00:00+00:00,-0.01,20013.3,2020-01,transport
2020-01-01 00:00:00+00:00,-0.01,20013.31,2020-01,entertainment
2020-01-01 00:00:00+00:00,-0.01,20013.32,2020-01,fees and charges
2020-01-01 00:00:00+00:00,-23.99,20037.31,2020-01,groceries / food spend
2020-01-01 00:00:00+00:00,-23.44,20060.75,2020-01,transfer
2020-01-01 00:00:00+00:00,-10.0,20070.75,2020-01,business services
2020-01-01 00:00:00+00:00,-11.11,20081.86,2020-01,bills and utilities
2020-01-01 00:00:00+00:00,-10.0,20091.86,2020-01,finances
2020-01-01 00:00:00+00:00,-12.67,20104.53,2020-01,finances
2020-01-01 00:00:00+00:00,-8.89,20113.42,2020-01,bills and utilities
2019-12-28 00:00:00+00:00,420.0,19693.42,2019-12,transfer
2019-12-28 00:00:00+00:00,-64.38,19757.8,2019-12,shopping
2019-12-28 00:00:00+00:00,40.81,19716.99,2019-12,transfer
2019-12-28 00:00:00+00:00,-32.72,19749.71,2019-12,transfer
2019-12-28 00:00:00+00:00,22.42,19727.29,2019-12,taxes
2019-12-27 00:00:00+00:00,-7.93,19735.22,2019-12,transfer
2019-12-27 00:00:00+00:00,92.69,19642.53,2019-12,transfer
2019-12-27 00:00:00+00:00,15.86,19626.67,2019-12,transfer
2019-12-27 00:00:00+00:00,-13.89,19640.56,2019-12,transport
2019-12-27 00:00:00+00:00,-2.99,19643.55,2019-12,finances
2019-12-27 00:00:00+00:00,-2.64,19646.19,2019-12,groceries / food spend
2019-12-27 00:00:00+00:00,-18.5,19664.69,2019-12,shopping
2019-12-25 00:00:00+00:00,70.0,19594.69,2019-12,transfer
2019-12-25 00:00:00+00:00,-53.98,19648.67,2019-12,entertainment
2019-12-25 00:00:00+00:00,-8.27,19656.94,2019-12,transfer
2019-12-25 00:00:00+00:00,-0.41,19657.35,2019-12,savings
2019-12-25 00:00:00+00:00,8.46,19648.89,2019-12,shopping
2019-12-25 00:00:00+00:00,-0.5,19649.39,2019-12,savings
2019-12-25 00:00:00+00:00,-10.5,19659.89,2019-12,entertainment
2019-12-23 00:00:00+00:00,-32.02,19691.91,2019-12,finances
2019-12-23 00:00:00+00:00,32.5,19659.41,2019-12,transfer
2019-12-23 00:00:00+00:00,-46.23,19705.64,2019-12,transfer
2019-12-23 00:00:00+00:00,-1.57,19707.21,2019-12,savings
2019-12-23 00:00:00+00:00,-20.0,19727.21,2019-12,transfer
2019-12-22 00:00:00+00:00,-10.72,19737.93,2019-12,shopping
2019-12-22 00:00:00+00:00,-0.01,19737.94,2019-12,savings
2019-12-22 00:00:00+00:00,-39.25,19777.19,2019-12,bills and utilities
2019-12-22 00:00:00+00:00,-38.15,19815.34,2019-12,shopping
2019-12-22 00:00:00+00:00,-42.0,19857.34,2019-12,finances
2019-12-20 00:00:00+00:00,-150.0,20007.34,2019-12,rent
2019-12-20 00:00:00+00:00,22.51,19984.83,2019-12,taxes
2019-12-20 00:00:00+00:00,-550.0,20534.83,2019-12,business services
2019-12-20 00:00:00+00:00,338.51,20196.32,2019-12,taxes
2019-12-19 00:00:00+00:00,-5.66,20201.98,2019-12,shopping
2019-12-19 00:00:00+00:00,1450.42,18751.56,2019-12,salary
2019-12-18 00:00:00+00:00,82.21,18669.35,2019-12,finances
2019-12-17 00:00:00+00:00,137.6,18531.75,2019-12,transfer
2019-12-17 00:00:00+00:00,-12.73,18544.48,2019-12,finances
2019-12-17 00:00:00+00:00,-41.68,18586.16,2019-12,finances
2019-12-17 00:00:00+00:00,-20.0,18606.16,2019-12,transport
2019-12-17 00:00:00+00:00,-0.69,18606.85,2019-12,savings
2019-12-17 00:00:00+00:00,-6.36,18613.21,2019-12,groceries / food spend
2019-12-15 00:00:00+00:00,-14.0,18627.21,2019-12,groceries / food spend
2019-12-15 00:00:00+00:00,-0.58,18627.79,2019-12,savings
2019-12-15 00:00:00+00:00,-15.45,18643.24,2019-12,shopping
2019-12-15 00:00:00+00:00,-0.54,18643.78,2019-12,savings
2019-12-15 00:00:00+00:00,-6.41,18650.19,2019-12,shopping
2019-12-15 00:00:00+00:00,-20.83,18671.02,2019-12,shopping
2019-12-14 00:00:00+00:00,-2.0,18673.02,2019-12,entertainment
2019-12-14 00:00:00+00:00,-25.22,18698.24,2019-12,entertainment
2019-12-14 00:00:00+00:00,51.58,18646.66,2019-12,entertainment
2019-12-12 00:00:00+00:00,-0.46,18647.12,2019-12,savings
2019-12-12 00:00:00+00:00,-23.11,18670.23,2019-12,transport
2019-12-11 00:00:00+00:00,50.0,18620.23,2019-12,finances
2019-12-11 00:00:00+00:00,50.0,18570.23,2019-12,transfer
2019-12-11 00:00:00+00:00,19.38,18550.85,2019-12,taxes
2019-12-11 00:00:00+00:00,-11.29,18562.14,2019-12,holidays
2019-12-10 00:00:00+00:00,-37.08,18599.22,2019-12,finances
2019-12-10 00:00:00+00:00,-3.11,18602.33,2019-12,groceries / food spend
2019-12-10 00:00:00+00:00,-0.06,18602.39,2019-12,transfer
2019-12-10 00:00:00+00:00,43.23,18559.16,2019-12,finances
2019-12-10 00:00:00+00:00,-18.67,18577.83,2019-12,transfer
2019-12-10 00:00:00+00:00,-30.28,18608.11,2019-12,bills and utilities
2019-12-09 00:00:00+00:00,-21.27,18629.38,2019-12,transport
2019-12-09 00:00:00+00:00,-21.31,18650.69,2019-12,taxes
2019-12-09 00:00:00+00:00,-0.5,18651.19,2019-12,savings
2019-12-09 00:00:00+00:00,70.0,18581.19,2019-12,transfer
2019-12-08 00:00:00+00:00,-0.01,18581.2,2019-12,savings
2019-12-08 00:00:00+00:00,22.42,18558.78,2019-12,taxes
2019-12-08 00:00:00+00:00,-19.21,18577.99,2019-12,fees and charges
2019-12-08 00:00:00+00:00,-100.0,18677.99,2019-12,rent
2019-12-08 00:00:00+00:00,-15.04,18693.03,2019-12,entertainment
2019-12-08 00:00:00+00:00,-0.79,18693.82,2019-12,savings
2019-12-08 00:00:00+00:00,-1.04,18694.86,2019-12,savings
2019-12-08 00:00:00+00:00,5.27,18689.59,2019-12,groceries / food spend
2019-12-07 00:00:00+00:00,-84.77,18774.36,2019-12,bills and utilities
2019-12-07 00:00:00+00:00,-1.03,18775.39,2019-12,savings
2019-12-07 00:00:00+00:00,-70.0,18845.39,2019-12,transfer
2019-12-06 00:00:00+00:00,-28.25,18873.64,2019-12,bills and utilities
2019-12-06 00:00:00+00:00,22.42,18851.22,2019-12,taxes
2019-12-06 00:00:00+00:00,-14.84,18866.06,2019-12,groceries / food spend
2019-12-06 00:00:00+00:00,-46.35,18912.41,2019-12,bills and utilities
2019-12-06 00:00:00+00:00,-7.6,18920.01,2019-12,home and garden
2019-12-06 00:00:00+00:00,366.47,18553.54,2019-12,taxes
2019-12-06 00:00:00+00:00,62.05,18491.49,2019-12,transfer
2019-12-06 00:00:00+00:00,61.89,18429.6,2019-12,transfer
2019-12-06 00:00:00+00:00,-0.01,18429.61,2019-12,savings
2019-12-06 00:00:00+00:00,-5.0,18434.61,2019-12,shopping
2019-12-05 00:00:00+00:00,-47.35,18481.96,2019-12,transfer
2019-12-05 00:00:00+00:00,-1.89,18483.85,2019-12,savings
2019-12-05 00:00:00+00:00,-6.34,18490.19,2019-12,finances
2019-12-05 00:00:00+00:00,-13.13,18503.32,2019-12,shopping
2019-12-05 00:00:00+00:00,-14.71,18518.03,2019-12,transfer
2019-12-05 00:00:00+00:00,-12.73,18530.76,2019-12,finances
2019-12-05 00:00:00+00:00,-6.37,18537.13,2019-12,groceries / food spend
2019-12-05 00:00:00+00:00,-20.0,18557.13,2019-12,shopping
2019-12-04 00:00:00+00:00,10.0,18547.13,2019-12,transfer
2019-12-04 00:00:00+00:00,70.0,18477.13,2019-12,transfer
2019-12-04 00:00:00+00:00,62.6,18414.53,2019-12,transfer
2019-12-04 00:00:00+00:00,-24.71,18439.24,2019-12,transfer
2019-12-04 00:00:00+00:00,-5.0,18444.24,2019-12,shopping
2019-12-04 00:00:00+00:00,-2.27,18446.51,2019-12,finances
2019-12-04 00:00:00+00:00,-81.99,18528.5,2019-12,transfer
2019-12-04 00:00:00+00:00,65.84,18462.66,2019-12,transfer
2019-12-04 00:00:00+00:00,-4.06,18466.72,2019-12,business services
2019-12-04 00:00:00+00:00,24.12,18442.6,2019-12,transfer
2019-12-04 00:00:00+00:00,-130.0,18572.6,2019-12,rent
2019-12-03 00:00:00+00:00,0.89,18571.71,2019-12,transfer
2019-12-03 00:00:00+00:00,-0.48,18572.19,2019-12,savings
2019-12-03 00:00:00+00:00,91.11,18481.08,2019-12,transfer
2019-12-03 00:00:00+00:00,7.0,18474.08,2019-12,transfer
2019-12-03 00:00:00+00:00,-23.11,18497.19,2019-12,transport
2019-12-03 00:00:00+00:00,-50.53,18547.72,2019-12,entertainment
2019-12-03 00:00:00+00:00,-0.01,18547.73,2019-12,savings
2019-12-03 00:00:00+00:00,-2.99,18550.72,2019-12,entertainment
2019-12-03 00:00:00+00:00,-30.0,18580.72,2019-12,shopping
2019-12-03 00:00:00+00:00,54.03,18526.69,2019-12,transfer
2019-12-03 00:00:00+00:00,-40.0,18566.69,2019-12,transfer
2019-12-03 00:00:00+00:00,-9.5,18576.19,2019-12,groceries / food spend
2019-12-02 00:00:00+00:00,32.09,18544.1,2019-12,transfer
2019-12-02 00:00:00+00:00,-30.07,18574.17,2019-12,transfer
2019-12-02 00:00:00+00:00,10.0,18564.17,2019-12,transfer
2019-12-02 00:00:00+00:00,-0.61,18564.78,2019-12,savings
2019-12-01 00:00:00+00:00,-46.82,18611.6,2019-12,bills and utilities
2019-12-01 00:00:00+00:00,-0.01,18611.61,2019-12,fees and charges
2019-12-01 00:00:00+00:00,-227.0,18838.61,2019-12,transfer
2019-12-01 00:00:00+00:00,-39.99,18878.6,2019-12,groceries / food spend
2019-12-01 00:00:00+00:00,-0.01,18878.61,2019-12,finances
2019-12-01 00:00:00+00:00,-0.02,18878.63,2019-12,shopping
2019-12-01 00:00:00+00:00,-0.01,18878.64,2019-12,shopping
2019-12-01 00:00:00+00:00,-0.01,18878.65,2019-12,groceries / food spend
2019-12-01 00:00:00+00:00,-0.01,18878.66,2019-12,groceries / food spend
2019-12-01 00:00:00+00:00,-0.02,18878.68,2019-12,groceries / food spend
2019-12-01 00:00:00+00:00,-0.0,18878.68,2019-12,groceries / food spend
2019-12-01 00:00:00+00:00,-0.01,18878.69,2019-12,transport
2019-12-01 00:00:00+00:00,-200.0,19078.69,2019-12,restaurants / eating out / delivery
2019-12-01 00:00:00+00:00,-0.01,19078.7,2019-12,home and garden
2019-12-01 00:00:00+00:00,-0.01,19078.71,2019-12,fees and charges
2019-12-01 00:00:00+00:00,-0.01,19078.72,2019-12,transport
2019-12-01 00:00:00+00:00,-0.01,19078.73,2019-12,entertainment
2019-12-01 00:00:00+00:00,-0.01,19078.74,2019-12,fees and charges
2019-12-01 00:00:00+00:00,-37.86,19116.6,2019-12,groceries / food spend
2019-12-01 00:00:00+00:00,-14.73,19131.33,2019-12,transfer
2019-12-01 00:00:00+00:00,-10.0,19141.33,2019-12,business services
2019-12-01 00:00:00+00:00,-10.0,19151.33,2019-12,bills and utilities
2019-12-01 00:00:00+00:00,-10.0,19161.33,2019-12,finances
2019-12-01 00:00:00+00:00,-11.86,19173.19,2019-12,finances
2019-12-01 00:00:00+00:00,-10.99,19184.18,2019-12,bills and utilities
2019-11-28 00:00:00+00:00,420.0,18764.18,2019-11,transfer
2019-11-28 00:00:00+00:00,-36.59,18800.77,2019-11,shopping
2019-11-28 00:00:00+00:00,40.0,18760.77,2019-11,transfer
2019-11-28 00:00:00+00:00,-39.76,18800.53,2019-11,transfer
2019-11-28 00:00:00+00:00,22.38,18778.15,2019-11,taxes
2019-11-27 00:00:00+00:00,-7.93,18786.08,2019-11,transfer
2019-11-27 00:00:00+00:00,50.59,18735.49,2019-11,transfer
2019-11-27 00:00:00+00:00,25.08,18710.41,2019-11,transfer
2019-11-27 00:00:00+00:00,-17.85,18728.26,2019-11,transport
2019-11-27 00:00:00+00:00,-3.62,18731.88,2019-11,finances
2019-11-27 00:00:00+00:00,-42.32,18774.2,2019-11,groceries / food spend
2019-11-27 00:00:00+00:00,-7.56,18781.76,2019-11,shopping
2019-11-25 00:00:00+00:00,81.22,18700.54,2019-11,transfer
2019-11-25 00:00:00+00:00,-25.55,18726.09,2019-11,entertainment
2019-11-25 00:00:00+00:00,-10.0,18736.09,2019-11,transfer
2019-11-25 00:00:00+00:00,-0.49,18736.58,2019-11,savings
2019-11-25 00:00:00+00:00,-36.59,18773.17,2019-11,shopping
2019-11-25 00:00:00+00:00,-0.5,18773.67,2019-11,savings
2019-11-25 00:00:00+00:00,-23.15,18796.82,2019-11,entertainment
2019-11-23 00:00:00+00:00,-30.0,18826.82,2019-11,finances
2019-11-23 00:00:00+00:00,32.5,18794.32,2019-11,transfer
2019-11-23 00:00:00+00:00,-100.0,18894.32,2019-11,transfer
2019-11-23 00:00:00+00:00,-1.31,18895.63,2019-11,savings
2019-11-23 00:00:00+00:00,-20.0,18915.63,2019-11,transfer
2019-11-22 00:00:00+00:00,-5.0,18920.63,2019-11,shopping
2019-11-22 00:00:00+00:00,-0.01,18920.64,2019-11,savings
2019-11-22 00:00:00+00:00,-39.25,18959.89,2019-11,bills and utilities
2019-11-22 00:00:00+00:00,-93.7,19053.59,2019-11,shopping
2019-11-22 00:00:00+00:00,-43.39,19096.98,2019-11,finances
2019-11-20 00:00:00+00:00,-150.0,19246.98,2019-11,rent
2019-11-20 00:00:00+00:00,22.42,19224.56,2019-11,taxes
2019-11-20 00:00:00+00:00,-236.01,19460.57,2019-11,business services
2019-11-20 00:00:00+00:00,320.62,19139.95,2019-11,taxes
2019-11-19 00:00:00+00:00,-7.99,19147.94,2019-11,shopping
2019-11-19 00:00:00+00:00,1450.42,17697.52,2019-11,salary
2019-11-18 00:00:00+00:00,106.97,17590.55,2019-11,finances
2019-11-17 00:00:00+00:00,233.67,17356.88,2019-11,transfer
2019-11-17 00:00:00+00:00,-12.73,17369.61,2019-11,finances
2019-11-17 00:00:00+00:00,-40.0,17409.61,2019-11,finances
2019-11-17 00:00:00+00:00,-20.0,17429.61,2019-11,transport
2019-11-17 00:00:00+00:00,-0.63,17430.24,2019-11,savings
2019-11-17 00:00:00+00:00,-1.41,17431.65,2019-11,groceries / food spend
2019-11-15 00:00:00+00:00,-32.0,17463.65,2019-11,groceries / food spend
2019-11-15 00:00:00+00:00,-0.55,17464.2,2019-11,savings
2019-11-15 00:00:00+00:00,2.37,17461.83,2019-11,shopping
2019-11-15 00:00:00+00:00,-0.5,17462.33,2019-11,savings
2019-11-15 00:00:00+00:00,-4.25,17466.58,2019-11,shopping
2019-11-15 00:00:00+00:00,-10.43,17477.01,2019-11,shopping
2019-11-14 00:00:00+00:00,-2.01,17479.02,2019-11,entertainment
2019-11-14 00:00:00+00:00,-20.5,17499.52,2019-11,entertainment
2019-11-14 00:00:00+00:00,2.84,17496.68,2019-11,entertainment
2019-11-12 00:00:00+00:00,-0.4,17497.08,2019-11,savings
2019-11-12 00:00:00+00:00,-23.11,17520.19,2019-11,transport
2019-11-11 00:00:00+00:00,50.0,17470.19,2019-11,finances
2019-11-11 00:00:00+00:00,67.46,17402.73,2019-11,transfer
2019-11-11 00:00:00+00:00,22.86,17379.87,2019-11,taxes
2019-11-11 00:00:00+00:00,-10.25,17390.12,2019-11,holidays
2019-11-10 00:00:00+00:00,-40.0,17430.12,2019-11,finances
2019-11-10 00:00:00+00:00,-5.18,17435.3,2019-11,groceries / food spend
2019-11-10 00:00:00+00:00,40.0,17395.3,2019-11,transfer
2019-11-10 00:00:00+00:00,50.36,17344.94,2019-11,finances
2019-11-10 00:00:00+00:00,-54.71,17399.65,2019-11,transfer
2019-11-10 00:00:00+00:00,-30.54,17430.19,2019-11,bills and utilities
2019-11-09 00:00:00+00:00,-24.28,17454.47,2019-11,transport
2019-11-09 00:00:00+00:00,-20.56,17475.03,2019-11,taxes
2019-11-09 00:00:00+00:00,-0.41,17475.44,2019-11,savings
2019-11-09 00:00:00+00:00,70.0,17405.44,2019-11,transfer
2019-11-08 00:00:00+00:00,-0.01,17405.45,2019-11,savings
2019-11-08 00:00:00+00:00,21.34,17384.11,2019-11,taxes
2019-11-08 00:00:00+00:00,-14.99,17399.1,2019-11,fees and charges
2019-11-08 00:00:00+00:00,-100.0,17499.1,2019-11,rent
2019-11-08 00:00:00+00:00,-10.0,17509.1,2019-11,entertainment
2019-11-08 00:00:00+00:00,-0.63,17509.73,2019-11,savings
2019-11-08 00:00:00+00:00,-1.04,17510.77,2019-11,savings
2019-11-08 00:00:00+00:00,-23.63,17534.4,2019-11,groceries / food spend
2019-11-07 00:00:00+00:00,-82.37,17616.77,2019-11,bills and utilities
2019-11-07 00:00:00+00:00,-1.25,17618.02,2019-11,savings
2019-11-07 00:00:00+00:00,-51.22,17669.24,2019-11,transfer
2019-11-06 00:00:00+00:00,-28.25,17697.49,2019-11,bills and utilities
2019-11-06 00:00:00+00:00,22.42,17675.07,2019-11,taxes
2019-11-06 00:00:00+00:00,-12.89,17687.96,2019-11,groceries / food spend
2019-11-06 00:00:00+00:00,-54.42,17742.38,2019-11,bills and utilities
2019-11-06 00:00:00+00:00,-9.71,17752.09,2019-11,home and garden
2019-11-06 00:00:00+00:00,346.35,17405.74,2019-11,taxes
2019-11-06 00:00:00+00:00,88.58,17317.16,2019-11,transfer
2019-11-06 00:00:00+00:00,61.89,17255.27,2019-11,transfer
2019-11-06 00:00:00+00:00,-0.01,17255.28,2019-11,savings
2019-11-06 00:00:00+00:00,-5.0,17260.28,2019-11,shopping
2019-11-05 00:00:00+00:00,-74.59,17334.87,2019-11,transfer
2019-11-05 00:00:00+00:00,-1.89,17336.76,2019-11,savings
2019-11-05 00:00:00+00:00,-5.79,17342.55,2019-11,finances
2019-11-05 00:00:00+00:00,-7.7,17350.25,2019-11,shopping
2019-11-05 00:00:00+00:00,-23.15,17373.4,2019-11,transfer
2019-11-05 00:00:00+00:00,-13.76,17387.16,2019-11,finances
2019-11-05 00:00:00+00:00,-6.37,17393.53,2019-11,groceries / food spend
2019-11-05 00:00:00+00:00,-26.32,17419.85,2019-11,shopping
2019-11-04 00:00:00+00:00,10.0,17409.85,2019-11,transfer
2019-11-04 00:00:00+00:00,70.0,17339.85,2019-11,transfer
2019-11-04 00:00:00+00:00,53.03,17286.82,2019-11,transfer
2019-11-04 00:00:00+00:00,-6.11,17292.93,2019-11,transfer
2019-11-04 00:00:00+00:00,-5.0,17297.93,2019-11,shopping
2019-11-04 00:00:00+00:00,-3.07,17301.0,2019-11,finances
2019-11-04 00:00:00+00:00,-142.65,17443.65,2019-11,transfer
2019-11-04 00:00:00+00:00,100.0,17343.65,2019-11,transfer
2019-11-04 00:00:00+00:00,-2.41,17346.06,2019-11,business services
2019-11-04 00:00:00+00:00,25.46,17320.6,2019-11,transfer
2019-11-04 00:00:00+00:00,-130.0,17450.6,2019-11,rent
2019-11-03 00:00:00+00:00,0.89,17449.71,2019-11,transfer
2019-11-03 00:00:00+00:00,-0.41,17450.12,2019-11,savings
2019-11-03 00:00:00+00:00,130.0,17320.12,2019-11,transfer
2019-11-03 00:00:00+00:00,7.0,17313.12,2019-11,transfer
2019-11-03 00:00:00+00:00,-23.11,17336.23,2019-11,transport
2019-11-03 00:00:00+00:00,35.49,17300.74,2019-11,entertainment
2019-11-03 00:00:00+00:00,-0.01,17300.75,2019-11,savings
2019-11-03 00:00:00+00:00,-2.07,17302.82,2019-11,entertainment
2019-11-03 00:00:00+00:00,-50.89,17353.71,2019-11,shopping
2019-11-03 00:00:00+00:00,37.31,17316.4,2019-11,transfer
2019-11-03 00:00:00+00:00,-31.0,17347.4,2019-11,transfer
2019-11-03 00:00:00+00:00,2.17,17345.23,2019-11,groceries / food spend
2019-11-02 00:00:00+00:00,35.0,17310.23,2019-11,transfer
2019-11-02 00:00:00+00:00,-9.44,17319.67,2019-11,transfer
2019-11-02 00:00:00+00:00,9.91,17309.76,2019-11,transfer
2019-11-02 00:00:00+00:00,-0.59,17310.35,2019-11,savings
2019-11-01 00:00:00+00:00,-46.82,17357.17,2019-11,bills and utilities
2019-11-01 00:00:00+00:00,-0.01,17357.18,2019-11,fees and charges
2019-11-01 00:00:00+00:00,-227.0,17584.18,2019-11,transfer
2019-11-01 00:00:00+00:00,-39.99,17624.17,2019-11,groceries / food spend
2019-11-01 00:00:00+00:00,-0.01,17624.18,2019-11,finances
2019-11-01 00:00:00+00:00,-0.01,17624.19,2019-11,shopping
2019-11-01 00:00:00+00:00,-0.01,17624.2,2019-11,shopping
2019-11-01 00:00:00+00:00,-0.01,17624.21,2019-11,groceries / food spend
2019-11-01 00:00:00+00:00,-0.01,17624.22,2019-11,groceries / food spend
2019-11-01 00:00:00+00:00,-0.01,17624.23,2019-11,groceries / food spend
2019-11-01 00:00:00+00:00,-0.01,17624.24,2019-11,groceries / food spend
2019-11-01 00:00:00+00:00,-0.01,17624.25,2019-11,transport
2019-11-01 00:00:00+00:00,-200.0,17824.25,2019-11,restaurants / eating out / delivery
2019-11-01 00:00:00+00:00,-0.02,17824.27,2019-11,home and garden
2019-11-01 00:00:00+00:00,-0.01,17824.28,2019-11,fees and charges
2019-11-01 00:00:00+00:00,-0.01,17824.29,2019-11,transport
2019-11-01 00:00:00+00:00,-0.02,17824.31,2019-11,entertainment
2019-11-01 00:00:00+00:00,-0.01,17824.32,2019-11,fees and charges
2019-11-01 00:00:00+00:00,-23.99,17848.31,2019-11,groceries / food spend
2019-11-01 00:00:00+00:00,-4.43,17852.74,2019-11,transfer
2019-11-01 00:00:00+00:00,-10.0,17862.74,2019-11,business services
2019-11-01 00:00:00+00:00,-10.0,17872.74,2019-11,bills and utilities
2019-11-01 00:00:00+00:00,-10.0,17882.74,2019-11,finances
2019-11-01 00:00:00+00:00,-10.89,17893.63,2019-11,finances
2019-11-01 00:00:00+00:00,-10.06,17903.69,2019-11,bills and utilities
2019-10-28 00:00:00+00:00,420.0,17483.69,2019-10,transfer
2019-10-28 00:00:00+00:00,-36.59,17520.28,2019-10,shopping
2019-10-28 00:00:00+00:00,27.26,17493.02,2019-10,transfer
2019-10-28 00:00:00+00:00,-36.78,17529.8,2019-10,transfer
2019-10-28 00:00:00+00:00,22.42,17507.38,2019-10,taxes
2019-10-27 00:00:00+00:00,-7.93,17515.31,2019-10,transfer
2019-10-27 00:00:00+00:00,15.07,17500.24,2019-10,transfer
2019-10-27 00:00:00+00:00,15.86,17484.38,2019-10,transfer
2019-10-27 00:00:00+00:00,-18.35,17502.73,2019-10,transport
2019-10-27 00:00:00+00:00,-2.42,17505.15,2019-10,finances
2019-10-27 00:00:00+00:00,-23.62,17528.77,2019-10,groceries / food spend
2019-10-27 00:00:00+00:00,-7.56,17536.33,2019-10,shopping
2019-10-25 00:00:00+00:00,70.0,17466.33,2019-10,transfer
2019-10-25 00:00:00+00:00,-36.09,17502.42,2019-10,entertainment
2019-10-25 00:00:00+00:00,-12.98,17515.4,2019-10,transfer
2019-10-25 00:00:00+00:00,-0.41,17515.81,2019-10,savings
2019-10-25 00:00:00+00:00,-36.59,17552.4,2019-10,shopping
2019-10-25 00:00:00+00:00,-0.52,17552.92,2019-10,savings
2019-10-25 00:00:00+00:00,0.39,17552.53,2019-10,entertainment
2019-10-23 00:00:00+00:00,-26.66,17579.19,2019-10,finances
2019-10-23 00:00:00+00:00,32.5,17546.69,2019-10,transfer
2019-10-23 00:00:00+00:00,-33.07,17579.76,2019-10,transfer
2019-10-23 00:00:00+00:00,-1.57,17581.33,2019-10,savings
2019-10-23 00:00:00+00:00,-20.0,17601.33,2019-10,transfer
2019-10-22 00:00:00+00:00,-5.0,17606.33,2019-10,shopping
2019-10-22 00:00:00+00:00,-0.01,17606.34,2019-10,savings
2019-10-22 00:00:00+00:00,-38.78,17645.12,2019-10,bills and utilities
2019-10-22 00:00:00+00:00,-36.59,17681.71,2019-10,shopping
2019-10-22 00:00:00+00:00,-43.61,17725.32,2019-10,finances
2019-10-20 00:00:00+00:00,-150.0,17875.32,2019-10,rent
2019-10-20 00:00:00+00:00,22.42,17852.9,2019-10,taxes
2019-10-20 00:00:00+00:00,-550.0,18402.9,2019-10,business services
2019-10-20 00:00:00+00:00,345.13,18057.77,2019-10,taxes
2019-10-19 00:00:00+00:00,-11.69,18069.46,2019-10,shopping
2019-10-19 00:00:00+00:00,1450.42,16619.04,2019-10,salary
2019-10-18 00:00:00+00:00,82.21,16536.83,2019-10,finances
2019-10-17 00:00:00+00:00,166.42,16370.41,2019-10,transfer
2019-10-17 00:00:00+00:00,-12.73,16383.14,2019-10,finances
2019-10-17 00:00:00+00:00,-18.0,16401.14,2019-10,finances
2019-10-17 00:00:00+00:00,-14.07,16415.21,2019-10,transport
2019-10-17 00:00:00+00:00,-0.63,16415.84,2019-10,savings
2019-10-17 00:00:00+00:00,-7.81,16423.65,2019-10,groceries / food spend
2019-10-15 00:00:00+00:00,-32.0,16455.65,2019-10,groceries / food spend
2019-10-15 00:00:00+00:00,-0.55,16456.2,2019-10,savings
2019-10-15 00:00:00+00:00,-5.17,16461.37,2019-10,shopping
2019-10-15 00:00:00+00:00,-0.47,16461.84,2019-10,savings
2019-10-15 00:00:00+00:00,-3.96,16465.8,2019-10,shopping
2019-10-15 00:00:00+00:00,-19.01,16484.81,2019-10,shopping
2019-10-14 00:00:00+00:00,-2.38,16487.19,2019-10,entertainment
2019-10-14 00:00:00+00:00,-5.47,16492.66,2019-10,entertainment
2019-10-14 00:00:00+00:00,43.5,16449.16,2019-10,entertainment
2019-10-12 00:00:00+00:00,-0.41,16449.57,2019-10,savings
2019-10-12 00:00:00+00:00,-23.11,16472.68,2019-10,transport
2019-10-11 00:00:00+00:00,50.0,16422.68,2019-10,finances
2019-10-11 00:00:00+00:00,33.63,16389.05,2019-10,transfer
2019-10-11 00:00:00+00:00,21.51,16367.54,2019-10,taxes
2019-10-11 00:00:00+00:00,-32.84,16400.38,2019-10,holidays
2019-10-10 00:00:00+00:00,-47.85,16448.23,2019-10,finances
2019-10-10 00:00:00+00:00,-2.2,16450.43,2019-10,groceries / food spend
2019-10-10 00:00:00+00:00,61.22,16389.21,2019-10,transfer
2019-10-10 00:00:00+00:00,50.36,16338.85,2019-10,finances
2019-10-10 00:00:00+00:00,-30.0,16368.85,2019-10,transfer
2019-10-10 00:00:00+00:00,-24.5,16393.35,2019-10,bills and utilities
2019-10-09 00:00:00+00:00,-27.81,16421.16,2019-10,transport
2019-10-09 00:00:00+00:00,-20.56,16441.72,2019-10,taxes
2019-10-09 00:00:00+00:00,-0.41,16442.13,2019-10,savings
2019-10-09 00:00:00+00:00,85.2,16356.93,2019-10,transfer
2019-10-08 00:00:00+00:00,-0.01,16356.94,2019-10,savings
2019-10-08 00:00:00+00:00,22.42,16334.52,2019-10,taxes
2019-10-08 00:00:00+00:00,-8.0,16342.52,2019-10,fees and charges
2019-10-08 00:00:00+00:00,-100.0,16442.52,2019-10,rent
2019-10-08 00:00:00+00:00,-13.8,16456.32,2019-10,entertainment
2019-10-08 00:00:00+00:00,-0.69,16457.01,2019-10,savings
2019-10-08 00:00:00+00:00,-1.19,16458.2,2019-10,savings
2019-10-08 00:00:00+00:00,-24.31,16482.51,2019-10,groceries / food spend
2019-10-07 00:00:00+00:00,-82.37,16564.88,2019-10,bills and utilities
2019-10-07 00:00:00+00:00,-1.17,16566.05,2019-10,savings
2019-10-07 00:00:00+00:00,-70.0,16636.05,2019-10,transfer
2019-10-06 00:00:00+00:00,-28.25,16664.3,2019-10,bills and utilities
2019-10-06 00:00:00+00:00,21.14,16643.16,2019-10,taxes
2019-10-06 00:00:00+00:00,-10.63,16653.79,2019-10,groceries / food spend
2019-10-06 00:00:00+00:00,-50.0,16703.79,2019-10,bills and utilities
2019-10-06 00:00:00+00:00,-1.39,16705.18,2019-10,home and garden
2019-10-06 00:00:00+00:00,346.35,16358.83,2019-10,taxes
2019-10-06 00:00:00+00:00,129.25,16229.58,2019-10,transfer
2019-10-06 00:00:00+00:00,25.12,16204.46,2019-10,transfer
2019-10-06 00:00:00+00:00,-0.01,16204.47,2019-10,savings
2019-10-06 00:00:00+00:00,-12.3,16216.77,2019-10,shopping
2019-10-05 00:00:00+00:00,-79.07,16295.84,2019-10,transfer
2019-10-05 00:00:00+00:00,-1.94,16297.78,2019-10,savings
2019-10-05 00:00:00+00:00,-4.63,16302.41,2019-10,finances
2019-10-05 00:00:00+00:00,-7.99,16310.4,2019-10,shopping
2019-10-05 00:00:00+00:00,-12.77,16323.17,2019-10,transfer
2019-10-05 00:00:00+00:00,-12.73,16335.9,2019-10,finances
2019-10-05 00:00:00+00:00,-6.37,16342.27,2019-10,groceries / food spend
2019-10-05 00:00:00+00:00,-9.77,16352.04,2019-10,shopping
2019-10-04 00:00:00+00:00,2.12,16349.92,2019-10,transfer
2019-10-04 00:00:00+00:00,70.0,16279.92,2019-10,transfer
2019-10-04 00:00:00+00:00,59.17,16220.75,2019-10,transfer
2019-10-04 00:00:00+00:00,-20.0,16240.75,2019-10,transfer
2019-10-04 00:00:00+00:00,-5.0,16245.75,2019-10,shopping
2019-10-04 00:00:00+00:00,-3.2,16248.95,2019-10,finances
2019-10-04 00:00:00+00:00,-138.73,16387.68,2019-10,transfer
2019-10-04 00:00:00+00:00,19.06,16368.62,2019-10,transfer
2019-10-04 00:00:00+00:00,-4.29,16372.91,2019-10,business services
2019-10-04 00:00:00+00:00,25.0,16347.91,2019-10,transfer
2019-10-04 00:00:00+00:00,-130.0,16477.91,2019-10,rent
2019-10-03 00:00:00+00:00,0.89,16477.02,2019-10,transfer
2019-10-03 00:00:00+00:00,-0.36,16477.38,2019-10,savings
2019-10-03 00:00:00+00:00,52.62,16424.76,2019-10,transfer
2019-10-03 00:00:00+00:00,8.45,16416.31,2019-10,transfer
2019-10-03 00:00:00+00:00,-23.11,16439.42,2019-10,transport
2019-10-03 00:00:00+00:00,41.96,16397.46,2019-10,entertainment
2019-10-03 00:00:00+00:00,-0.01,16397.47,2019-10,savings
2019-10-03 00:00:00+00:00,0.75,16396.72,2019-10,entertainment
2019-10-03 00:00:00+00:00,-30.0,16426.72,2019-10,shopping
2019-10-03 00:00:00+00:00,54.41,16372.31,2019-10,transfer
2019-10-03 00:00:00+00:00,-40.0,16412.31,2019-10,transfer
2019-10-03 00:00:00+00:00,-5.0,16417.31,2019-10,groceries / food spend
2019-10-02 00:00:00+00:00,18.73,16398.58,2019-10,transfer
2019-10-02 00:00:00+00:00,-36.01,16434.59,2019-10,transfer
2019-10-02 00:00:00+00:00,6.11,16428.48,2019-10,transfer
2019-10-02 00:00:00+00:00,-0.59,16429.07,2019-10,savings
2019-10-01 00:00:00+00:00,-46.82,16475.89,2019-10,bills and utilities
2019-10-01 00:00:00+00:00,-0.01,16475.9,2019-10,fees and charges
2019-10-01 00:00:00+00:00,-227.0,16702.9,2019-10,transfer
2019-10-01 00:00:00+00:00,-39.99,16742.89,2019-10,groceries / food spend
2019-10-01 00:00:00+00:00,-0.01,16742.9,2019-10,finances
2019-10-01 00:00:00+00:00,-0.01,16742.91,2019-10,shopping
2019-10-01 00:00:00+00:00,-0.01,16742.92,2019-10,shopping
2019-10-01 00:00:00+00:00,-0.01,16742.93,2019-10,groceries / food spend
2019-10-01 00:00:00+00:00,-0.02,16742.95,2019-10,groceries / food spend
2019-10-01 00:00:00+00:00,-0.01,16742.96,2019-10,groceries / food spend
2019-10-01 00:00:00+00:00,-0.01,16742.97,2019-10,groceries / food spend
2019-10-01 00:00:00+00:00,-0.02,16742.99,2019-10,transport
2019-10-01 00:00:00+00:00,-200.0,16942.99,2019-10,restaurants / eating out / delivery
2019-10-01 00:00:00+00:00,-0.01,16943.0,2019-10,home and garden
2019-10-01 00:00:00+00:00,-0.0,16943.0,2019-10,fees and charges
2019-10-01 00:00:00+00:00,-0.01,16943.01,2019-10,transport
2019-10-01 00:00:00+00:00,-0.0,16943.01,2019-10,entertainment
2019-10-01 00:00:00+00:00,-0.01,16943.02,2019-10,fees and charges
2019-10-01 00:00:00+00:00,-26.5,16969.52,2019-10,groceries / food spend
2019-10-01 00:00:00+00:00,-1.54,16971.06,2019-10,transfer
2019-10-01 00:00:00+00:00,-5.75,16976.81,2019-10,business services
2019-10-01 00:00:00+00:00,-10.0,16986.81,2019-10,bills and utilities
2019-10-01 00:00:00+00:00,-11.81,16998.62,2019-10,finances
2019-10-01 00:00:00+00:00,-7.33,17005.95,2019-10,finances
2019-10-01 00:00:00+00:00,-10.26,17016.21,2019-10,bills and utilities
2019-09-28 00:00:00+00:00,589.78,16426.43,2019-09,transfer
2019-09-28 00:00:00+00:00,13.1,16413.33,2019-09,shopping
2019-09-28 00:00:00+00:00,40.0,16373.33,2019-09,transfer
2019-09-28 00:00:00+00:00,-43.17,16416.5,2019-09,transfer
2019-09-28 00:00:00+00:00,22.42,16394.08,2019-09,taxes
2019-09-27 00:00:00+00:00,-7.93,16402.01,2019-09,transfer
2019-09-27 00:00:00+00:00,50.59,16351.42,2019-09,transfer
2019-09-27 00:00:00+00:00,18.2,16333.22,2019-09,transfer
2019-09-27 00:00:00+00:00,-20.56,16353.78,2019-09,transport
2019-09-27 00:00:00+00:00,-3.31,16357.09,2019-09,finances
2019-09-27 00:00:00+00:00,-23.62,16380.71,2019-09,groceries / food spend
2019-09-27 00:00:00+00:00,-7.56,16388.27,2019-09,shopping
2019-09-25 00:00:00+00:00,128.3,16259.97,2019-09,transfer
2019-09-25 00:00:00+00:00,-24.5,16284.47,2019-09,entertainment
2019-09-25 00:00:00+00:00,-10.0,16294.47,2019-09,transfer
2019-09-25 00:00:00+00:00,-0.41,16294.88,2019-09,savings
2019-09-25 00:00:00+00:00,-46.43,16341.31,2019-09,shopping
2019-09-25 00:00:00+00:00,-0.5,16341.81,2019-09,savings
2019-09-25 00:00:00+00:00,-10.5,16352.31,2019-09,entertainment
2019-09-23 00:00:00+00:00,-34.94,16387.25,2019-09,finances
2019-09-23 00:00:00+00:00,-2.36,16389.61,2019-09,transfer
2019-09-23 00:00:00+00:00,-12.87,16402.48,2019-09,transfer
2019-09-23 00:00:00+00:00,-1.57,16404.05,2019-09,savings
2019-09-23 00:00:00+00:00,-20.0,16424.05,2019-09,transfer
2019-09-22 00:00:00+00:00,-8.02,16432.07,2019-09,shopping
2019-09-22 00:00:00+00:00,-0.01,16432.08,2019-09,savings
2019-09-22 00:00:00+00:00,-38.25,16470.33,2019-09,bills and utilities
2019-09-22 00:00:00+00:00,-29.2,16499.53,2019-09,shopping
2019-09-22 00:00:00+00:00,-36.59,16536.12,2019-09,finances
2019-09-20 00:00:00+00:00,-150.0,16686.12,2019-09,rent
2019-09-20 00:00:00+00:00,23.28,16662.84,2019-09,taxes
2019-09-20 00:00:00+00:00,-550.0,17212.84,2019-09,business services
2019-09-20 00:00:00+00:00,345.13,16867.71,2019-09,taxes
2019-09-19 00:00:00+00:00,-4.67,16872.38,2019-09,shopping
2019-09-19 00:00:00+00:00,1450.42,15421.96,2019-09,salary
2019-09-18 00:00:00+00:00,78.89,15343.07,2019-09,finances
2019-09-17 00:00:00+00:00,51.42,15291.65,2019-09,transfer
2019-09-17 00:00:00+00:00,-12.73,15304.38,2019-09,finances
2019-09-17 00:00:00+00:00,-40.0,15344.38,2019-09,finances
2019-09-17 00:00:00+00:00,-20.0,15364.38,2019-09,transport
2019-09-17 00:00:00+00:00,-0.63,15365.01,2019-09,savings
2019-09-17 00:00:00+00:00,-5.21,15370.22,2019-09,groceries / food spend
2019-09-15 00:00:00+00:00,-13.72,15383.94,2019-09,groceries / food spend
2019-09-15 00:00:00+00:00,-0.58,15384.52,2019-09,savings
2019-09-15 00:00:00+00:00,-16.17,15400.69,2019-09,shopping
2019-09-15 00:00:00+00:00,-0.5,15401.19,2019-09,savings
2019-09-15 00:00:00+00:00,-9.54,15410.73,2019-09,shopping
2019-09-15 00:00:00+00:00,-11.5,15422.23,2019-09,shopping
2019-09-14 00:00:00+00:00,-2.0,15424.23,2019-09,entertainment
2019-09-14 00:00:00+00:00,-20.5,15444.73,2019-09,entertainment
2019-09-14 00:00:00+00:00,43.5,15401.23,2019-09,entertainment
2019-09-12 00:00:00+00:00,-0.41,15401.64,2019-09,savings
2019-09-12 00:00:00+00:00,-23.11,15424.75,2019-09,transport
2019-09-11 00:00:00+00:00,66.75,15358.0,2019-09,finances
2019-09-11 00:00:00+00:00,27.1,15330.9,2019-09,transfer
2019-09-11 00:00:00+00:00,22.42,15308.48,2019-09,taxes
2019-09-11 00:00:00+00:00,-17.0,15325.48,2019-09,holidays
2019-09-10 00:00:00+00:00,-38.81,15364.29,2019-09,finances
2019-09-10 00:00:00+00:00,-11.2,15375.49,2019-09,groceries / food spend
2019-09-10 00:00:00+00:00,79.75,15295.74,2019-09,transfer
2019-09-10 00:00:00+00:00,35.76,15259.98,2019-09,finances
2019-09-10 00:00:00+00:00,-64.95,15324.93,2019-09,transfer
2019-09-10 00:00:00+00:00,-24.5,15349.43,2019-09,bills and utilities
2019-09-09 00:00:00+00:00,-22.31,15371.74,2019-09,transport
2019-09-09 00:00:00+00:00,-21.05,15392.79,2019-09,taxes
2019-09-09 00:00:00+00:00,-0.4,15393.19,2019-09,savings
2019-09-09 00:00:00+00:00,70.0,15323.19,2019-09,transfer
2019-09-08 00:00:00+00:00,-0.01,15323.2,2019-09,savings
2019-09-08 00:00:00+00:00,20.79,15302.41,2019-09,taxes
2019-09-08 00:00:00+00:00,-19.71,15322.12,2019-09,fees and charges
2019-09-08 00:00:00+00:00,-100.0,15422.12,2019-09,rent
2019-09-08 00:00:00+00:00,-10.0,15432.12,2019-09,entertainment
2019-09-08 00:00:00+00:00,-0.69,15432.81,2019-09,savings
2019-09-08 00:00:00+00:00,-1.28,15434.09,2019-09,savings
2019-09-08 00:00:00+00:00,-24.31,15458.4,2019-09,groceries / food spend
2019-09-07 00:00:00+00:00,-69.47,15527.87,2019-09,bills and utilities
2019-09-07 00:00:00+00:00,-1.12,15528.99,2019-09,savings
2019-09-07 00:00:00+00:00,-70.0,15598.99,2019-09,transfer
2019-09-06 00:00:00+00:00,-31.76,15630.75,2019-09,bills and utilities
2019-09-06 00:00:00+00:00,22.42,15608.33,2019-09,taxes
2019-09-06 00:00:00+00:00,-2.74,15611.07,2019-09,groceries / food spend
2019-09-06 00:00:00+00:00,-54.32,15665.39,2019-09,bills and utilities
2019-09-06 00:00:00+00:00,-9.71,15675.1,2019-09,home and garden
2019-09-06 00:00:00+00:00,346.35,15328.75,2019-09,taxes
2019-09-06 00:00:00+00:00,137.6,15191.15,2019-09,transfer
2019-09-06 00:00:00+00:00,52.43,15138.72,2019-09,transfer
2019-09-06 00:00:00+00:00,-0.01,15138.73,2019-09,savings
2019-09-06 00:00:00+00:00,-7.73,15146.46,2019-09,shopping
2019-09-05 00:00:00+00:00,-60.0,15206.46,2019-09,transfer
2019-09-05 00:00:00+00:00,-2.16,15208.62,2019-09,savings
2019-09-05 00:00:00+00:00,-5.79,15214.41,2019-09,finances
2019-09-05 00:00:00+00:00,-0.22,15214.63,2019-09,shopping
2019-09-05 00:00:00+00:00,-15.39,15230.02,2019-09,transfer
2019-09-05 00:00:00+00:00,-12.73,15242.75,2019-09,finances
2019-09-05 00:00:00+00:00,-10.55,15253.3,2019-09,groceries / food spend
2019-09-05 00:00:00+00:00,-35.46,15288.76,2019-09,shopping
2019-09-04 00:00:00+00:00,10.0,15278.76,2019-09,transfer
2019-09-04 00:00:00+00:00,50.67,15228.09,2019-09,transfer
2019-09-04 00:00:00+00:00,59.17,15168.92,2019-09,transfer
2019-09-04 00:00:00+00:00,-20.0,15188.92,2019-09,transfer
2019-09-04 00:00:00+00:00,-5.0,15193.92,2019-09,shopping
2019-09-04 00:00:00+00:00,-2.86,15196.78,2019-09,finances
2019-09-04 00:00:00+00:00,-100.0,15296.78,2019-09,transfer
2019-09-04 00:00:00+00:00,100.0,15196.78,2019-09,transfer
2019-09-04 00:00:00+00:00,-5.48,15202.26,2019-09,business services
2019-09-04 00:00:00+00:00,37.92,15164.34,2019-09,transfer
2019-09-04 00:00:00+00:00,-130.0,15294.34,2019-09,rent
2019-09-03 00:00:00+00:00,0.43,15293.91,2019-09,transfer
2019-09-03 00:00:00+00:00,-0.38,15294.29,2019-09,savings
2019-09-03 00:00:00+00:00,65.66,15228.63,2019-09,transfer
2019-09-03 00:00:00+00:00,7.0,15221.63,2019-09,transfer
2019-09-03 00:00:00+00:00,-23.11,15244.74,2019-09,transport
2019-09-03 00:00:00+00:00,35.49,15209.25,2019-09,entertainment
2019-09-03 00:00:00+00:00,-0.01,15209.26,2019-09,savings
2019-09-03 00:00:00+00:00,-2.88,15212.14,2019-09,entertainment
2019-09-03 00:00:00+00:00,-29.16,15241.3,2019-09,shopping
2019-09-03 00:00:00+00:00,40.0,15201.3,2019-09,transfer
2019-09-03 00:00:00+00:00,-32.08,15233.38,2019-09,transfer
2019-09-03 00:00:00+00:00,-5.0,15238.38,2019-09,groceries / food spend
2019-09-02 00:00:00+00:00,39.53,15198.85,2019-09,transfer
2019-09-02 00:00:00+00:00,-30.0,15228.85,2019-09,transfer
2019-09-02 00:00:00+00:00,10.0,15218.85,2019-09,transfer
2019-09-02 00:00:00+00:00,-0.6,15219.45,2019-09,savings
2019-09-01 00:00:00+00:00,-46.82,15266.27,2019-09,bills and utilities
2019-09-01 00:00:00+00:00,-0.01,15266.28,2019-09,fees and charges
2019-09-01 00:00:00+00:00,-227.0,15493.28,2019-09,transfer
2019-09-01 00:00:00+00:00,-39.6,15532.88,2019-09,groceries / food spend
2019-09-01 00:00:00+00:00,-0.01,15532.89,2019-09,finances
2019-09-01 00:00:00+00:00,-0.01,15532.9,2019-09,shopping
2019-09-01 00:00:00+00:00,-0.01,15532.91,2019-09,shopping
2019-09-01 00:00:00+00:00,-0.01,15532.92,2019-09,groceries / food spend
2019-09-01 00:00:00+00:00,-0.01,15532.93,2019-09,groceries / food spend
2019-09-01 00:00:00+00:00,-0.01,15532.94,2019-09,groceries / food spend
2019-09-01 00:00:00+00:00,-0.01,15532.95,2019-09,groceries / food spend
2019-09-01 00:00:00+00:00,-0.01,15532.96,2019-09,transport
2019-09-01 00:00:00+00:00,-312.23,15845.19,2019-09,restaurants / eating out / delivery
2019-09-01 00:00:00+00:00,-0.01,15845.2,2019-09,home and garden
2019-09-01 00:00:00+00:00,-0.01,15845.21,2019-09,fees and charges
2019-09-01 00:00:00+00:00,-0.01,15845.22,2019-09,transport
2019-09-01 00:00:00+00:00,-0.01,15845.23,2019-09,entertainment
2019-09-01 00:00:00+00:00,-0.01,15845.24,2019-09,fees and charges
2019-09-01 00:00:00+00:00,-23.99,15869.23,2019-09,groceries / food spend
2019-09-01 00:00:00+00:00,-20.91,15890.14,2019-09,transfer
2019-09-01 00:00:00+00:00,-1.31,15891.45,2019-09,business services
2019-09-01 00:00:00+00:00,-10.0,15901.45,2019-09,bills and utilities
2019-09-01 00:00:00+00:00,-11.06,15912.51,2019-09,finances
2019-09-01 00:00:00+00:00,-11.81,15924.32,2019-09,finances
2019-09-01 00:00:00+00:00,-8.88,15933.2,2019-09,bills and utilities
2019-08-28 00:00:00+00:00,420.0,15513.2,2019-08,transfer
2019-08-28 00:00:00+00:00,-36.59,15549.79,2019-08,shopping
2019-08-28 00:00:00+00:00,42.21,15507.58,2019-08,transfer
2019-08-28 00:00:00+00:00,-32.72,15540.3,2019-08,transfer
2019-08-28 00:00:00+00:00,22.42,15517.88,2019-08,taxes
2019-08-27 00:00:00+00:00,-7.93,15525.81,2019-08,transfer
2019-08-27 00:00:00+00:00,50.59,15475.22,2019-08,transfer
2019-08-27 00:00:00+00:00,12.74,15462.48,2019-08,transfer
2019-08-27 00:00:00+00:00,-20.56,15483.04,2019-08,transport
2019-08-27 00:00:00+00:00,-3.03,15486.07,2019-08,finances
2019-08-27 00:00:00+00:00,-23.62,15509.69,2019-08,groceries / food spend
2019-08-27 00:00:00+00:00,-7.56,15517.25,2019-08,shopping
2019-08-25 00:00:00+00:00,50.63,15466.62,2019-08,transfer
2019-08-25 00:00:00+00:00,-44.81,15511.43,2019-08,entertainment
2019-08-25 00:00:00+00:00,-10.86,15522.29,2019-08,transfer
2019-08-25 00:00:00+00:00,-0.43,15522.72,2019-08,savings
2019-08-25 00:00:00+00:00,-36.59,15559.31,2019-08,shopping
2019-08-25 00:00:00+00:00,-0.5,15559.81,2019-08,savings
2019-08-25 00:00:00+00:00,-10.5,15570.31,2019-08,entertainment
2019-08-23 00:00:00+00:00,-30.0,15600.31,2019-08,finances
2019-08-23 00:00:00+00:00,38.63,15561.68,2019-08,transfer
2019-08-23 00:00:00+00:00,-60.87,15622.55,2019-08,transfer
2019-08-23 00:00:00+00:00,-1.92,15624.47,2019-08,savings
2019-08-23 00:00:00+00:00,-18.69,15643.16,2019-08,transfer
2019-08-22 00:00:00+00:00,-8.5,15651.66,2019-08,shopping
2019-08-22 00:00:00+00:00,-0.01,15651.67,2019-08,savings
2019-08-22 00:00:00+00:00,-38.27,15689.94,2019-08,bills and utilities
2019-08-22 00:00:00+00:00,4.11,15685.83,2019-08,shopping
2019-08-22 00:00:00+00:00,-36.59,15722.42,2019-08,finances
2019-08-20 00:00:00+00:00,-150.0,15872.42,2019-08,rent
2019-08-20 00:00:00+00:00,23.4,15849.02,2019-08,taxes
2019-08-20 00:00:00+00:00,-550.0,16399.02,2019-08,business services
2019-08-20 00:00:00+00:00,345.13,16053.89,2019-08,taxes
2019-08-19 00:00:00+00:00,-7.99,16061.88,2019-08,shopping
2019-08-19 00:00:00+00:00,1450.42,14611.46,2019-08,salary
2019-08-18 00:00:00+00:00,82.21,14529.25,2019-08,finances
2019-08-17 00:00:00+00:00,209.04,14320.21,2019-08,transfer
2019-08-17 00:00:00+00:00,-12.73,14332.94,2019-08,finances
2019-08-17 00:00:00+00:00,-56.05,14388.99,2019-08,finances
2019-08-17 00:00:00+00:00,-20.0,14408.99,2019-08,transport
2019-08-17 00:00:00+00:00,-0.67,14409.66,2019-08,savings
2019-08-17 00:00:00+00:00,-17.1,14426.76,2019-08,groceries / food spend
2019-08-15 00:00:00+00:00,-32.0,14458.76,2019-08,groceries / food spend
2019-08-15 00:00:00+00:00,-0.6,14459.36,2019-08,savings
2019-08-15 00:00:00+00:00,-7.3,14466.66,2019-08,shopping
2019-08-15 00:00:00+00:00,-0.5,14467.16,2019-08,savings
2019-08-15 00:00:00+00:00,-3.78,14470.94,2019-08,shopping
2019-08-15 00:00:00+00:00,-10.93,14481.87,2019-08,shopping
2019-08-14 00:00:00+00:00,-5.89,14487.76,2019-08,entertainment
2019-08-14 00:00:00+00:00,-20.5,14508.26,2019-08,entertainment
2019-08-14 00:00:00+00:00,-27.01,14535.27,2019-08,entertainment
2019-08-12 00:00:00+00:00,-0.5,14535.77,2019-08,savings
2019-08-12 00:00:00+00:00,-23.11,14558.88,2019-08,transport
2019-08-11 00:00:00+00:00,46.74,14512.14,2019-08,finances
2019-08-11 00:00:00+00:00,36.6,14475.54,2019-08,transfer
2019-08-11 00:00:00+00:00,23.57,14451.97,2019-08,taxes
2019-08-11 00:00:00+00:00,-17.0,14468.97,2019-08,holidays
2019-08-10 00:00:00+00:00,-40.0,14508.97,2019-08,finances
2019-08-10 00:00:00+00:00,-6.18,14515.15,2019-08,groceries / food spend
2019-08-10 00:00:00+00:00,31.04,14484.11,2019-08,transfer
2019-08-10 00:00:00+00:00,50.36,14433.75,2019-08,finances
2019-08-10 00:00:00+00:00,-47.61,14481.36,2019-08,transfer
2019-08-10 00:00:00+00:00,-24.5,14505.86,2019-08,bills and utilities
2019-08-09 00:00:00+00:00,-23.62,14529.48,2019-08,transport
2019-08-09 00:00:00+00:00,-20.82,14550.3,2019-08,taxes
2019-08-09 00:00:00+00:00,-0.39,14550.69,2019-08,savings
2019-08-09 00:00:00+00:00,70.0,14480.69,2019-08,transfer
2019-08-08 00:00:00+00:00,-0.01,14480.7,2019-08,savings
2019-08-08 00:00:00+00:00,22.21,14458.49,2019-08,taxes
2019-08-08 00:00:00+00:00,-14.99,14473.48,2019-08,fees and charges
2019-08-08 00:00:00+00:00,-100.0,14573.48,2019-08,rent
2019-08-08 00:00:00+00:00,-10.0,14583.48,2019-08,entertainment
2019-08-08 00:00:00+00:00,-0.69,14584.17,2019-08,savings
2019-08-08 00:00:00+00:00,-0.96,14585.13,2019-08,savings
2019-08-08 00:00:00+00:00,-60.44,14645.57,2019-08,groceries / food spend
2019-08-07 00:00:00+00:00,-82.37,14727.94,2019-08,bills and utilities
2019-08-07 00:00:00+00:00,-1.15,14729.09,2019-08,savings
2019-08-07 00:00:00+00:00,-70.0,14799.09,2019-08,transfer
2019-08-06 00:00:00+00:00,-32.04,14831.13,2019-08,bills and utilities
2019-08-06 00:00:00+00:00,22.42,14808.71,2019-08,taxes
2019-08-06 00:00:00+00:00,-12.89,14821.6,2019-08,groceries / food spend
2019-08-06 00:00:00+00:00,-50.0,14871.6,2019-08,bills and utilities
2019-08-06 00:00:00+00:00,-3.8,14875.4,2019-08,home and garden
2019-08-06 00:00:00+00:00,346.35,14529.05,2019-08,taxes
2019-08-06 00:00:00+00:00,200.53,14328.52,2019-08,transfer
2019-08-06 00:00:00+00:00,61.89,14266.63,2019-08,transfer
2019-08-06 00:00:00+00:00,-0.01,14266.64,2019-08,savings
2019-08-06 00:00:00+00:00,-5.0,14271.64,2019-08,shopping
2019-08-05 00:00:00+00:00,-60.0,14331.64,2019-08,transfer
2019-08-05 00:00:00+00:00,-1.89,14333.53,2019-08,savings
2019-08-05 00:00:00+00:00,-3.72,14337.25,2019-08,finances
2019-08-05 00:00:00+00:00,-15.07,14352.32,2019-08,shopping
2019-08-05 00:00:00+00:00,-23.15,14375.47,2019-08,transfer
2019-08-05 00:00:00+00:00,-14.29,14389.76,2019-08,finances
2019-08-05 00:00:00+00:00,-6.37,14396.13,2019-08,groceries / food spend
2019-08-05 00:00:00+00:00,-27.4,14423.53,2019-08,shopping
2019-08-04 00:00:00+00:00,10.0,14413.53,2019-08,transfer
2019-08-04 00:00:00+00:00,87.86,14325.67,2019-08,transfer
2019-08-04 00:00:00+00:00,48.42,14277.25,2019-08,transfer
2019-08-04 00:00:00+00:00,-37.29,14314.54,2019-08,transfer
2019-08-04 00:00:00+00:00,-4.64,14319.18,2019-08,shopping
2019-08-04 00:00:00+00:00,-3.23,14322.41,2019-08,finances
2019-08-04 00:00:00+00:00,-100.0,14422.41,2019-08,transfer
2019-08-04 00:00:00+00:00,100.0,14322.41,2019-08,transfer
2019-08-04 00:00:00+00:00,-3.59,14326.0,2019-08,business services
2019-08-04 00:00:00+00:00,25.0,14301.0,2019-08,transfer
2019-08-04 00:00:00+00:00,-130.0,14431.0,2019-08,rent
2019-08-03 00:00:00+00:00,-0.13,14431.13,2019-08,transfer
2019-08-03 00:00:00+00:00,-0.41,14431.54,2019-08,savings
2019-08-03 00:00:00+00:00,54.08,14377.46,2019-08,transfer
2019-08-03 00:00:00+00:00,4.61,14372.85,2019-08,transfer
2019-08-03 00:00:00+00:00,-23.11,14395.96,2019-08,transport
2019-08-03 00:00:00+00:00,35.49,14360.47,2019-08,entertainment
2019-08-03 00:00:00+00:00,-0.01,14360.48,2019-08,savings
2019-08-03 00:00:00+00:00,-1.25,14361.73,2019-08,entertainment
2019-08-03 00:00:00+00:00,-30.0,14391.73,2019-08,shopping
2019-08-03 00:00:00+00:00,30.52,14361.21,2019-08,transfer
2019-08-03 00:00:00+00:00,-56.48,14417.69,2019-08,transfer
2019-08-03 00:00:00+00:00,2.22,14415.47,2019-08,groceries / food spend
2019-08-02 00:00:00+00:00,30.0,14385.47,2019-08,transfer
2019-08-02 00:00:00+00:00,-10.61,14396.08,2019-08,transfer
2019-08-02 00:00:00+00:00,10.0,14386.08,2019-08,transfer
2019-08-02 00:00:00+00:00,-0.57,14386.65,2019-08,savings
2019-08-01 00:00:00+00:00,-46.82,14433.47,2019-08,bills and utilities
2019-08-01 00:00:00+00:00,-0.01,14433.48,2019-08,fees and charges
2019-08-01 00:00:00+00:00,-301.62,14735.1,2019-08,transfer
2019-08-01 00:00:00+00:00,-39.99,14775.09,2019-08,groceries / food spend
2019-08-01 00:00:00+00:00,-0.01,14775.1,2019-08,finances
2019-08-01 00:00:00+00:00,-0.02,14775.12,2019-08,shopping
2019-08-01 00:00:00+00:00,-0.01,14775.13,2019-08,shopping
2019-08-01 00:00:00+00:00,-0.01,14775.14,2019-08,groceries / food spend
2019-08-01 00:00:00+00:00,-0.01,14775.15,2019-08,groceries / food spend
2019-08-01 00:00:00+00:00,-0.01,14775.16,2019-08,groceries / food spend
2019-08-01 00:00:00+00:00,0.01,14775.15,2019-08,groceries / food spend
2019-08-01 00:00:00+00:00,-0.02,14775.17,2019-08,transport
2019-08-01 00:00:00+00:00,-96.77,14871.94,2019-08,restaurants / eating out / delivery
2019-08-01 00:00:00+00:00,-0.01,14871.95,2019-08,home and garden
2019-08-01 00:00:00+00:00,-0.01,14871.96,2019-08,fees and charges
2019-08-01 00:00:00+00:00,-0.01,14871.97,2019-08,transport
2019-08-01 00:00:00+00:00,-0.01,14871.98,2019-08,entertainment
2019-08-01 00:00:00+00:00,-0.01,14871.99,2019-08,fees and charges
2019-08-01 00:00:00+00:00,-26.44,14898.43,2019-08,groceries / food spend
2019-08-01 00:00:00+00:00,-20.91,14919.34,2019-08,transfer
2019-08-01 00:00:00+00:00,-9.63,14928.97,2019-08,business services
2019-08-01 00:00:00+00:00,-10.0,14938.97,2019-08,bills and utilities
2019-08-01 00:00:00+00:00,-10.0,14948.97,2019-08,finances
2019-08-01 00:00:00+00:00,-13.08,14962.05,2019-08,finances
2019-08-01 00:00:00+00:00,-8.72,14970.77,2019-08,bills and utilities
2019-07-28 00:00:00+00:00,801.06,14169.71,2019-07,transfer
2019-07-28 00:00:00+00:00,-60.57,14230.28,2019-07,shopping
2019-07-28 00:00:00+00:00,52.78,14177.5,2019-07,transfer
2019-07-28 00:00:00+00:00,-24.64,14202.14,2019-07,transfer
2019-07-28 00:00:00+00:00,22.55,14179.59,2019-07,taxes
2019-07-27 00:00:00+00:00,-7.93,14187.52,2019-07,transfer
2019-07-27 00:00:00+00:00,43.24,14144.28,2019-07,transfer
2019-07-27 00:00:00+00:00,12.21,14132.07,2019-07,transfer
2019-07-27 00:00:00+00:00,-20.56,14152.63,2019-07,transport
2019-07-27 00:00:00+00:00,-4.1,14156.73,2019-07,finances
2019-07-27 00:00:00+00:00,-29.33,14186.06,2019-07,groceries / food spend
2019-07-27 00:00:00+00:00,0.62,14185.44,2019-07,shopping
2019-07-25 00:00:00+00:00,40.71,14144.73,2019-07,transfer
2019-07-25 00:00:00+00:00,-9.15,14153.88,2019-07,entertainment
2019-07-25 00:00:00+00:00,-10.0,14163.88,2019-07,transfer
2019-07-25 00:00:00+00:00,-0.45,14164.33,2019-07,savings
2019-07-25 00:00:00+00:00,-46.03,14210.36,2019-07,shopping
2019-07-25 00:00:00+00:00,-0.5,14210.86,2019-07,savings
2019-07-25 00:00:00+00:00,-10.5,14221.36,2019-07,entertainment
2019-07-23 00:00:00+00:00,-16.84,14238.2,2019-07,finances
2019-07-23 00:00:00+00:00,27.21,14210.99,2019-07,transfer
2019-07-23 00:00:00+00:00,-47.95,14258.94,2019-07,transfer
2019-07-23 00:00:00+00:00,-1.77,14260.71,2019-07,savings
2019-07-23 00:00:00+00:00,-28.71,14289.42,2019-07,transfer
2019-07-22 00:00:00+00:00,-5.0,14294.42,2019-07,shopping
2019-07-22 00:00:00+00:00,-0.01,14294.43,2019-07,savings
2019-07-22 00:00:00+00:00,-39.25,14333.68,2019-07,bills and utilities
2019-07-22 00:00:00+00:00,-11.4,14345.08,2019-07,shopping
2019-07-22 00:00:00+00:00,-36.59,14381.67,2019-07,finances
2019-07-20 00:00:00+00:00,-150.0,14531.67,2019-07,rent
2019-07-20 00:00:00+00:00,22.75,14508.92,2019-07,taxes
2019-07-20 00:00:00+00:00,-490.99,14999.91,2019-07,business services
2019-07-20 00:00:00+00:00,345.13,14654.78,2019-07,taxes
2019-07-19 00:00:00+00:00,-14.65,14669.43,2019-07,shopping
2019-07-19 00:00:00+00:00,1450.42,13219.01,2019-07,salary
2019-07-18 00:00:00+00:00,53.96,13165.05,2019-07,finances
2019-07-17 00:00:00+00:00,174.17,12990.88,2019-07,transfer
2019-07-17 00:00:00+00:00,-8.58,12999.46,2019-07,finances
2019-07-17 00:00:00+00:00,-61.21,13060.67,2019-07,finances
2019-07-17 00:00:00+00:00,-20.0,13080.67,2019-07,transport
2019-07-17 00:00:00+00:00,-0.64,13081.31,2019-07,savings
2019-07-17 00:00:00+00:00,-3.32,13084.63,2019-07,groceries / food spend
2019-07-15 00:00:00+00:00,-32.0,13116.63,2019-07,groceries / food spend
2019-07-15 00:00:00+00:00,-0.55,13117.18,2019-07,savings
2019-07-15 00:00:00+00:00,-15.45,13132.63,2019-07,shopping
2019-07-15 00:00:00+00:00,-0.46,13133.09,2019-07,savings
2019-07-15 00:00:00+00:00,-0.51,13133.6,2019-07,shopping
2019-07-15 00:00:00+00:00,-10.0,13143.6,2019-07,shopping
2019-07-14 00:00:00+00:00,-2.0,13145.6,2019-07,entertainment
2019-07-14 00:00:00+00:00,-20.5,13166.1,2019-07,entertainment
2019-07-14 00:00:00+00:00,43.5,13122.6,2019-07,entertainment
2019-07-12 00:00:00+00:00,-0.45,13123.05,2019-07,savings
2019-07-12 00:00:00+00:00,-30.91,13153.96,2019-07,transport
2019-07-11 00:00:00+00:00,62.42,13091.54,2019-07,finances
2019-07-11 00:00:00+00:00,50.0,13041.54,2019-07,transfer
2019-07-11 00:00:00+00:00,22.42,13019.12,2019-07,taxes
2019-07-11 00:00:00+00:00,-27.74,13046.86,2019-07,holidays
2019-07-10 00:00:00+00:00,-40.0,13086.86,2019-07,finances
2019-07-10 00:00:00+00:00,0.2,13086.66,2019-07,groceries / food spend
2019-07-10 00:00:00+00:00,40.0,13046.66,2019-07,transfer
2019-07-10 00:00:00+00:00,65.72,12980.94,2019-07,finances
2019-07-10 00:00:00+00:00,-56.78,13037.72,2019-07,transfer
2019-07-10 00:00:00+00:00,-21.86,13059.58,2019-07,bills and utilities
2019-07-09 00:00:00+00:00,-18.81,13078.39,2019-07,transport
2019-07-09 00:00:00+00:00,-20.56,13098.95,2019-07,taxes
2019-07-09 00:00:00+00:00,-0.41,13099.36,2019-07,savings
2019-07-09 00:00:00+00:00,74.21,13025.15,2019-07,transfer
2019-07-08 00:00:00+00:00,-0.01,13025.16,2019-07,savings
2019-07-08 00:00:00+00:00,22.42,13002.74,2019-07,taxes
2019-07-08 00:00:00+00:00,-9.93,13012.67,2019-07,fees and charges
2019-07-08 00:00:00+00:00,-100.0,13112.67,2019-07,rent
2019-07-08 00:00:00+00:00,-10.0,13122.67,2019-07,entertainment
2019-07-08 00:00:00+00:00,-0.7,13123.37,2019-07,savings
2019-07-08 00:00:00+00:00,-1.04,13124.41,2019-07,savings
2019-07-08 00:00:00+00:00,-1.6,13126.01,2019-07,groceries / food spend
2019-07-07 00:00:00+00:00,-78.43,13204.44,2019-07,bills and utilities
2019-07-07 00:00:00+00:00,-1.08,13205.52,2019-07,savings
2019-07-07 00:00:00+00:00,-110.75,13316.27,2019-07,transfer
2019-07-06 00:00:00+00:00,-28.25,13344.52,2019-07,bills and utilities
2019-07-06 00:00:00+00:00,21.24,13323.28,2019-07,taxes
2019-07-06 00:00:00+00:00,-12.89,13336.17,2019-07,groceries / food spend
2019-07-06 00:00:00+00:00,-48.01,13384.18,2019-07,bills and utilities
2019-07-06 00:00:00+00:00,-9.71,13393.89,2019-07,home and garden
2019-07-06 00:00:00+00:00,362.73,13031.16,2019-07,taxes
2019-07-06 00:00:00+00:00,153.47,12877.69,2019-07,transfer
2019-07-06 00:00:00+00:00,61.89,12815.8,2019-07,transfer
2019-07-06 00:00:00+00:00,-0.01,12815.81,2019-07,savings
2019-07-06 00:00:00+00:00,-5.0,12820.81,2019-07,shopping
2019-07-05 00:00:00+00:00,-60.0,12880.81,2019-07,transfer
2019-07-05 00:00:00+00:00,-1.89,12882.7,2019-07,savings
2019-07-05 00:00:00+00:00,-6.86,12889.56,2019-07,finances
2019-07-05 00:00:00+00:00,-7.99,12897.55,2019-07,shopping
2019-07-05 00:00:00+00:00,-23.15,12920.7,2019-07,transfer
2019-07-05 00:00:00+00:00,-14.81,12935.51,2019-07,finances
2019-07-05 00:00:00+00:00,-6.37,12941.88,2019-07,groceries / food spend
2019-07-05 00:00:00+00:00,6.16,12935.72,2019-07,shopping
2019-07-04 00:00:00+00:00,11.73,12923.99,2019-07,transfer
2019-07-04 00:00:00+00:00,32.89,12891.1,2019-07,transfer
2019-07-04 00:00:00+00:00,67.2,12823.9,2019-07,transfer
2019-07-04 00:00:00+00:00,-9.56,12833.46,2019-07,transfer
2019-07-04 00:00:00+00:00,-5.0,12838.46,2019-07,shopping
2019-07-04 00:00:00+00:00,-3.07,12841.53,2019-07,finances
2019-07-04 00:00:00+00:00,-98.29,12939.82,2019-07,transfer
2019-07-04 00:00:00+00:00,100.0,12839.82,2019-07,transfer
2019-07-04 00:00:00+00:00,-3.59,12843.41,2019-07,business services
2019-07-04 00:00:00+00:00,25.0,12818.41,2019-07,transfer
2019-07-04 00:00:00+00:00,-130.0,12948.41,2019-07,rent
2019-07-03 00:00:00+00:00,0.89,12947.52,2019-07,transfer
2019-07-03 00:00:00+00:00,-0.41,12947.93,2019-07,savings
2019-07-03 00:00:00+00:00,130.0,12817.93,2019-07,transfer
2019-07-03 00:00:00+00:00,4.75,12813.18,2019-07,transfer
2019-07-03 00:00:00+00:00,-23.11,12836.29,2019-07,transport
2019-07-03 00:00:00+00:00,35.49,12800.8,2019-07,entertainment
2019-07-03 00:00:00+00:00,-0.01,12800.81,2019-07,savings
2019-07-03 00:00:00+00:00,-2.99,12803.8,2019-07,entertainment
2019-07-03 00:00:00+00:00,-30.0,12833.8,2019-07,shopping
2019-07-03 00:00:00+00:00,49.35,12784.45,2019-07,transfer
2019-07-03 00:00:00+00:00,-17.71,12802.16,2019-07,transfer
2019-07-03 00:00:00+00:00,-5.0,12807.16,2019-07,groceries / food spend
2019-07-02 00:00:00+00:00,-0.29,12807.45,2019-07,transfer
2019-07-02 00:00:00+00:00,-30.0,12837.45,2019-07,transfer
2019-07-02 00:00:00+00:00,10.0,12827.45,2019-07,transfer
2019-07-02 00:00:00+00:00,-0.59,12828.04,2019-07,savings
2019-07-01 00:00:00+00:00,-46.62,12874.66,2019-07,bills and utilities
2019-07-01 00:00:00+00:00,-0.01,12874.67,2019-07,fees and charges
2019-07-01 00:00:00+00:00,-256.27,13130.94,2019-07,transfer
2019-07-01 00:00:00+00:00,-23.9,13154.84,2019-07,groceries / food spend
2019-07-01 00:00:00+00:00,-0.01,13154.85,2019-07,finances
2019-07-01 00:00:00+00:00,-0.02,13154.87,2019-07,shopping
2019-07-01 00:00:00+00:00,-0.01,13154.88,2019-07,shopping
2019-07-01 00:00:00+00:00,-0.01,13154.89,2019-07,groceries / food spend
2019-07-01 00:00:00+00:00,-0.01,13154.9,2019-07,groceries / food spend
2019-07-01 00:00:00+00:00,-0.0,13154.9,2019-07,groceries / food spend
2019-07-01 00:00:00+00:00,0.0,13154.9,2019-07,groceries / food spend
2019-07-01 00:00:00+00:00,-0.01,13154.91,2019-07,transport
2019-07-01 00:00:00+00:00,-200.0,13354.91,2019-07,restaurants / eating out / delivery
2019-07-01 00:00:00+00:00,-0.01,13354.92,2019-07,home and garden
2019-07-01 00:00:00+00:00,-0.01,13354.93,2019-07,fees and charges
2019-07-01 00:00:00+00:00,-0.01,13354.94,2019-07,transport
2019-07-01 00:00:00+00:00,-0.01,13354.95,2019-07,entertainment
2019-07-01 00:00:00+00:00,-0.01,13354.96,2019-07,fees and charges
2019-07-01 00:00:00+00:00,-23.99,13378.95,2019-07,groceries / food spend
2019-07-01 00:00:00+00:00,-20.91,13399.86,2019-07,transfer
2019-07-01 00:00:00+00:00,-10.0,13409.86,2019-07,business services
2019-07-01 00:00:00+00:00,-9.99,13419.85,2019-07,bills and utilities
2019-07-01 00:00:00+00:00,-10.0,13429.85,2019-07,finances
2019-07-01 00:00:00+00:00,-12.13,13441.98,2019-07,finances
2019-07-01 00:00:00+00:00,-10.0,13451.98,2019-07,bills and utilities
2019-06-28 00:00:00+00:00,7.97,13444.01,2019-06,transfer
2019-06-28 00:00:00+00:00,-36.59,13480.6,2019-06,shopping
2019-06-28 00:00:00+00:00,55.38,13425.22,2019-06,transfer
2019-06-28 00:00:00+00:00,-32.72,13457.94,2019-06,transfer
2019-06-28 00:00:00+00:00,22.42,13435.52,2019-06,taxes
2019-06-27 00:00:00+00:00,-7.48,13443.0,2019-06,transfer
2019-06-27 00:00:00+00:00,50.59,13392.41,2019-06,transfer
2019-06-27 00:00:00+00:00,20.93,13371.48,2019-06,transfer
2019-06-27 00:00:00+00:00,-20.56,13392.04,2019-06,transport
2019-06-27 00:00:00+00:00,-2.99,13395.03,2019-06,finances
2019-06-27 00:00:00+00:00,-23.62,13418.65,2019-06,groceries / food spend
2019-06-27 00:00:00+00:00,-8.73,13427.38,2019-06,shopping
2019-06-25 00:00:00+00:00,13.67,13413.71,2019-06,transfer
2019-06-25 00:00:00+00:00,-24.5,13438.21,2019-06,entertainment
2019-06-25 00:00:00+00:00,-10.0,13448.21,2019-06,transfer
2019-06-25 00:00:00+00:00,-0.41,13448.62,2019-06,savings
2019-06-25 00:00:00+00:00,-36.59,13485.21,2019-06,shopping
2019-06-25 00:00:00+00:00,-0.5,13485.71,2019-06,savings
2019-06-25 00:00:00+00:00,-10.5,13496.21,2019-06,entertainment
2019-06-23 00:00:00+00:00,-16.55,13512.76,2019-06,finances
2019-06-23 00:00:00+00:00,32.5,13480.26,2019-06,transfer
2019-06-23 00:00:00+00:00,-100.0,13580.26,2019-06,transfer
2019-06-23 00:00:00+00:00,-1.48,13581.74,2019-06,savings
2019-06-23 00:00:00+00:00,-13.97,13595.71,2019-06,transfer
2019-06-22 00:00:00+00:00,-5.0,13600.71,2019-06,shopping
2019-06-22 00:00:00+00:00,-0.01,13600.72,2019-06,savings
2019-06-22 00:00:00+00:00,-39.25,13639.97,2019-06,bills and utilities
2019-06-22 00:00:00+00:00,-36.59,13676.56,2019-06,shopping
2019-06-22 00:00:00+00:00,-36.59,13713.15,2019-06,finances
2019-06-20 00:00:00+00:00,-150.0,13863.15,2019-06,rent
2019-06-20 00:00:00+00:00,22.42,13840.73,2019-06,taxes
2019-06-20 00:00:00+00:00,-823.28,14664.01,2019-06,business services
2019-06-20 00:00:00+00:00,333.75,14330.26,2019-06,taxes
2019-06-19 00:00:00+00:00,-7.99,14338.25,2019-06,shopping
2019-06-19 00:00:00+00:00,1450.42,12887.83,2019-06,salary
2019-06-18 00:00:00+00:00,82.21,12805.62,2019-06,finances
2019-06-17 00:00:00+00:00,137.6,12668.02,2019-06,transfer
2019-06-17 00:00:00+00:00,-10.1,12678.12,2019-06,finances
2019-06-17 00:00:00+00:00,-34.66,12712.78,2019-06,finances
2019-06-17 00:00:00+00:00,-26.72,12739.5,2019-06,transport
2019-06-17 00:00:00+00:00,-0.63,12740.13,2019-06,savings
2019-06-17 00:00:00+00:00,-10.89,12751.02,2019-06,groceries / food spend
2019-06-15 00:00:00+00:00,-30.67,12781.69,2019-06,groceries / food spend
2019-06-15 00:00:00+00:00,-0.54,12782.23,2019-06,savings
2019-06-15 00:00:00+00:00,-15.45,12797.68,2019-06,shopping
2019-06-15 00:00:00+00:00,-0.47,12798.15,2019-06,savings
2019-06-15 00:00:00+00:00,-1.75,12799.9,2019-06,shopping
2019-06-15 00:00:00+00:00,0.12,12799.78,2019-06,shopping
2019-06-14 00:00:00+00:00,-3.09,12802.87,2019-06,entertainment
2019-06-14 00:00:00+00:00,-20.84,12823.71,2019-06,entertainment
2019-06-14 00:00:00+00:00,38.03,12785.68,2019-06,entertainment
2019-06-12 00:00:00+00:00,-0.41,12786.09,2019-06,savings
2019-06-12 00:00:00+00:00,-15.54,12801.63,2019-06,transport
2019-06-11 00:00:00+00:00,64.05,12737.58,2019-06,finances
2019-06-11 00:00:00+00:00,50.0,12687.58,2019-06,transfer
2019-06-11 00:00:00+00:00,22.42,12665.16,2019-06,taxes
2019-06-11 00:00:00+00:00,-17.0,12682.16,2019-06,holidays
2019-06-10 00:00:00+00:00,-38.86,12721.02,2019-06,finances
2019-06-10 00:00:00+00:00,-5.0,12726.02,2019-06,groceries / food spend
2019-06-10 00:00:00+00:00,40.0,12686.02,2019-06,transfer
2019-06-10 00:00:00+00:00,47.95,12638.07,2019-06,finances
2019-06-10 00:00:00+00:00,-30.0,12668.07,2019-06,transfer
2019-06-10 00:00:00+00:00,-22.7,12690.77,2019-06,bills and utilities
2019-06-09 00:00:00+00:00,-23.62,12714.39,2019-06,transport
2019-06-09 00:00:00+00:00,-18.5,12732.89,2019-06,taxes
2019-06-09 00:00:00+00:00,-0.41,12733.3,2019-06,savings
2019-06-09 00:00:00+00:00,70.0,12663.3,2019-06,transfer
2019-06-08 00:00:00+00:00,-0.01,12663.31,2019-06,savings
2019-06-08 00:00:00+00:00,21.35,12641.96,2019-06,taxes
2019-06-08 00:00:00+00:00,-14.99,12656.95,2019-06,fees and charges
2019-06-08 00:00:00+00:00,-100.0,12756.95,2019-06,rent
2019-06-08 00:00:00+00:00,-10.22,12767.17,2019-06,entertainment
2019-06-08 00:00:00+00:00,-0.69,12767.86,2019-06,savings
2019-06-08 00:00:00+00:00,-1.0,12768.86,2019-06,savings
2019-06-08 00:00:00+00:00,-25.35,12794.21,2019-06,groceries / food spend
2019-06-07 00:00:00+00:00,-82.49,12876.7,2019-06,bills and utilities
2019-06-07 00:00:00+00:00,-1.15,12877.85,2019-06,savings
2019-06-07 00:00:00+00:00,-70.0,12947.85,2019-06,transfer
2019-06-06 00:00:00+00:00,-22.59,12970.44,2019-06,bills and utilities
2019-06-06 00:00:00+00:00,22.83,12947.61,2019-06,taxes
2019-06-06 00:00:00+00:00,-12.89,12960.5,2019-06,groceries / food spend
2019-06-06 00:00:00+00:00,-49.18,13009.68,2019-06,bills and utilities
2019-06-06 00:00:00+00:00,-9.71,13019.39,2019-06,home and garden
2019-06-06 00:00:00+00:00,322.72,12696.67,2019-06,taxes
2019-06-06 00:00:00+00:00,137.6,12559.07,2019-06,transfer
2019-06-06 00:00:00+00:00,61.89,12497.18,2019-06,transfer
2019-06-06 00:00:00+00:00,-0.01,12497.19,2019-06,savings
2019-06-06 00:00:00+00:00,-10.92,12508.11,2019-06,shopping
2019-06-05 00:00:00+00:00,-62.58,12570.69,2019-06,transfer
2019-06-05 00:00:00+00:00,-1.89,12572.58,2019-06,savings
2019-06-05 00:00:00+00:00,-5.79,12578.37,2019-06,finances
2019-06-05 00:00:00+00:00,-7.99,12586.36,2019-06,shopping
2019-06-05 00:00:00+00:00,-23.15,12609.51,2019-06,transfer
2019-06-05 00:00:00+00:00,-12.73,12622.24,2019-06,finances
2019-06-05 00:00:00+00:00,-6.37,12628.61,2019-06,groceries / food spend
2019-06-05 00:00:00+00:00,-3.11,12631.72,2019-06,shopping
2019-06-04 00:00:00+00:00,10.54,12621.18,2019-06,transfer
2019-06-04 00:00:00+00:00,46.03,12575.15,2019-06,transfer
2019-06-04 00:00:00+00:00,53.17,12521.98,2019-06,transfer
2019-06-04 00:00:00+00:00,-36.6,12558.58,2019-06,transfer
2019-06-04 00:00:00+00:00,-5.0,12563.58,2019-06,shopping
2019-06-04 00:00:00+00:00,-2.48,12566.06,2019-06,finances
2019-06-04 00:00:00+00:00,-100.0,12666.06,2019-06,transfer
2019-06-04 00:00:00+00:00,261.39,12404.67,2019-06,transfer
2019-06-04 00:00:00+00:00,-3.59,12408.26,2019-06,business services
2019-06-04 00:00:00+00:00,25.0,12383.26,2019-06,transfer
2019-06-04 00:00:00+00:00,-130.0,12513.26,2019-06,rent
2019-06-03 00:00:00+00:00,1.2,12512.06,2019-06,transfer
2019-06-03 00:00:00+00:00,-0.41,12512.47,2019-06,savings
2019-06-03 00:00:00+00:00,130.0,12382.47,2019-06,transfer
2019-06-03 00:00:00+00:00,13.67,12368.8,2019-06,transfer
2019-06-03 00:00:00+00:00,-23.11,12391.91,2019-06,transport
2019-06-03 00:00:00+00:00,58.77,12333.14,2019-06,entertainment
2019-06-03 00:00:00+00:00,-0.01,12333.15,2019-06,savings
2019-06-03 00:00:00+00:00,-0.96,12334.11,2019-06,entertainment
2019-06-03 00:00:00+00:00,-7.93,12342.04,2019-06,shopping
2019-06-03 00:00:00+00:00,40.0,12302.04,2019-06,transfer
2019-06-03 00:00:00+00:00,-19.03,12321.07,2019-06,transfer
2019-06-03 00:00:00+00:00,-5.0,12326.07,2019-06,groceries / food spend
2019-06-02 00:00:00+00:00,16.53,12309.54,2019-06,transfer
2019-06-02 00:00:00+00:00,-30.0,12339.54,2019-06,transfer
2019-06-02 00:00:00+00:00,10.0,12329.54,2019-06,transfer
2019-06-02 00:00:00+00:00,-0.59,12330.13,2019-06,savings
2019-06-01 00:00:00+00:00,-46.68,12376.81,2019-06,bills and utilities
2019-06-01 00:00:00+00:00,-0.01,12376.82,2019-06,fees and charges
2019-06-01 00:00:00+00:00,-227.0,12603.82,2019-06,transfer
2019-06-01 00:00:00+00:00,-39.99,12643.81,2019-06,groceries / food spend
2019-06-01 00:00:00+00:00,-0.01,12643.82,2019-06,finances
2019-06-01 00:00:00+00:00,-0.01,12643.83,2019-06,shopping
2019-06-01 00:00:00+00:00,-0.01,12643.84,2019-06,shopping
2019-06-01 00:00:00+00:00,-0.0,12643.84,2019-06,groceries / food spend
2019-06-01 00:00:00+00:00,-0.01,12643.85,2019-06,groceries / food spend
2019-06-01 00:00:00+00:00,-0.01,12643.86,2019-06,groceries / food spend
2019-06-01 00:00:00+00:00,-0.01,12643.87,2019-06,groceries / food spend
2019-06-01 00:00:00+00:00,-0.01,12643.88,2019-06,transport
2019-06-01 00:00:00+00:00,-200.0,12843.88,2019-06,restaurants / eating out / delivery
2019-06-01 00:00:00+00:00,-0.01,12843.89,2019-06,home and garden
2019-06-01 00:00:00+00:00,-0.01,12843.9,2019-06,fees and charges
2019-06-01 00:00:00+00:00,-0.01,12843.91,2019-06,transport
2019-06-01 00:00:00+00:00,-0.02,12843.93,2019-06,entertainment
2019-06-01 00:00:00+00:00,-0.01,12843.94,2019-06,fees and charges
2019-06-01 00:00:00+00:00,-18.7,12862.64,2019-06,groceries / food spend
2019-06-01 00:00:00+00:00,-35.37,12898.01,2019-06,transfer
2019-06-01 00:00:00+00:00,-10.0,12908.01,2019-06,business services
2019-06-01 00:00:00+00:00,-9.61,12917.62,2019-06,bills and utilities
2019-06-01 00:00:00+00:00,-8.17,12925.79,2019-06,finances
2019-06-01 00:00:00+00:00,-10.0,12935.79,2019-06,finances
2019-06-01 00:00:00+00:00,-10.0,12945.79,2019-06,bills and utilities
2019-05-28 00:00:00+00:00,-372.78,13318.57,2019-05,transfer
2019-05-28 00:00:00+00:00,-47.7,13366.27,2019-05,shopping
2019-05-28 00:00:00+00:00,52.89,13313.38,2019-05,transfer
2019-05-28 00:00:00+00:00,-32.72,13346.1,2019-05,transfer
2019-05-28 00:00:00+00:00,22.42,13323.68,2019-05,taxes
2019-05-27 00:00:00+00:00,-7.93,13331.61,2019-05,transfer
2019-05-27 00:00:00+00:00,41.74,13289.87,2019-05,transfer
2019-05-27 00:00:00+00:00,19.57,13270.3,2019-05,transfer
2019-05-27 00:00:00+00:00,-20.56,13290.86,2019-05,transport
2019-05-27 00:00:00+00:00,-2.99,13293.85,2019-05,finances
2019-05-27 00:00:00+00:00,-14.85,13308.7,2019-05,groceries / food spend
2019-05-27 00:00:00+00:00,-7.24,13315.94,2019-05,shopping
2019-05-25 00:00:00+00:00,70.0,13245.94,2019-05,transfer
2019-05-25 00:00:00+00:00,13.54,13232.4,2019-05,entertainment
2019-05-25 00:00:00+00:00,-10.0,13242.4,2019-05,transfer
2019-05-25 00:00:00+00:00,-0.41,13242.81,2019-05,savings
2019-05-25 00:00:00+00:00,-36.59,13279.4,2019-05,shopping
2019-05-25 00:00:00+00:00,-0.52,13279.92,2019-05,savings
2019-05-25 00:00:00+00:00,-15.55,13295.47,2019-05,entertainment
2019-05-23 00:00:00+00:00,-30.0,13325.47,2019-05,finances
2019-05-23 00:00:00+00:00,38.13,13287.34,2019-05,transfer
2019-05-23 00:00:00+00:00,-100.0,13387.34,2019-05,transfer
2019-05-23 00:00:00+00:00,-1.49,13388.83,2019-05,savings
2019-05-23 00:00:00+00:00,-20.0,13408.83,2019-05,transfer
2019-05-22 00:00:00+00:00,-5.0,13413.83,2019-05,shopping
2019-05-22 00:00:00+00:00,-0.01,13413.84,2019-05,savings
2019-05-22 00:00:00+00:00,-35.11,13448.95,2019-05,bills and utilities
2019-05-22 00:00:00+00:00,-83.11,13532.06,2019-05,shopping
2019-05-22 00:00:00+00:00,-36.59,13568.65,2019-05,finances
2019-05-20 00:00:00+00:00,-150.0,13718.65,2019-05,rent
2019-05-20 00:00:00+00:00,22.42,13696.23,2019-05,taxes
2019-05-20 00:00:00+00:00,-550.0,14246.23,2019-05,business services
2019-05-20 00:00:00+00:00,345.13,13901.1,2019-05,taxes
2019-05-19 00:00:00+00:00,-9.35,13910.45,2019-05,shopping
2019-05-19 00:00:00+00:00,1450.42,12460.03,2019-05,salary
2019-05-18 00:00:00+00:00,56.8,12403.23,2019-05,finances
2019-05-17 00:00:00+00:00,137.6,12265.63,2019-05,transfer
2019-05-17 00:00:00+00:00,-11.62,12277.25,2019-05,finances
2019-05-17 00:00:00+00:00,-32.15,12309.4,2019-05,finances
2019-05-17 00:00:00+00:00,-28.61,12338.01,2019-05,transport
2019-05-17 00:00:00+00:00,-0.63,12338.64,2019-05,savings
2019-05-17 00:00:00+00:00,-6.37,12345.01,2019-05,groceries / food spend
2019-05-15 00:00:00+00:00,-32.0,12377.01,2019-05,groceries / food spend
2019-05-15 00:00:00+00:00,-0.55,12377.56,2019-05,savings
2019-05-15 00:00:00+00:00,-15.45,12393.01,2019-05,shopping
2019-05-15 00:00:00+00:00,-0.55,12393.56,2019-05,savings
2019-05-15 00:00:00+00:00,-3.59,12397.15,2019-05,shopping
2019-05-15 00:00:00+00:00,-10.0,12407.15,2019-05,shopping
2019-05-14 00:00:00+00:00,-3.64,12410.79,2019-05,entertainment
2019-05-14 00:00:00+00:00,-20.5,12431.29,2019-05,entertainment
2019-05-14 00:00:00+00:00,32.46,12398.83,2019-05,entertainment
2019-05-12 00:00:00+00:00,-0.41,12399.24,2019-05,savings
2019-05-12 00:00:00+00:00,-25.42,12424.66,2019-05,transport
2019-05-11 00:00:00+00:00,58.23,12366.43,2019-05,finances
2019-05-11 00:00:00+00:00,50.0,12316.43,2019-05,transfer
2019-05-11 00:00:00+00:00,22.42,12294.01,2019-05,taxes
2019-05-11 00:00:00+00:00,-17.0,12311.01,2019-05,holidays
2019-05-10 00:00:00+00:00,-40.0,12351.01,2019-05,finances
2019-05-10 00:00:00+00:00,-5.0,12356.01,2019-05,groceries / food spend
2019-05-10 00:00:00+00:00,19.45,12336.56,2019-05,transfer
2019-05-10 00:00:00+00:00,50.36,12286.2,2019-05,finances
2019-05-10 00:00:00+00:00,-30.0,12316.2,2019-05,transfer
2019-05-10 00:00:00+00:00,-24.5,12340.7,2019-05,bills and utilities
2019-05-09 00:00:00+00:00,-23.62,12364.32,2019-05,transport
2019-05-09 00:00:00+00:00,-19.38,12383.7,2019-05,taxes
2019-05-09 00:00:00+00:00,-0.41,12384.11,2019-05,savings
2019-05-09 00:00:00+00:00,93.63,12290.48,2019-05,transfer
2019-05-08 00:00:00+00:00,-0.01,12290.49,2019-05,savings
2019-05-08 00:00:00+00:00,21.67,12268.82,2019-05,taxes
2019-05-08 00:00:00+00:00,-16.01,12284.83,2019-05,fees and charges
2019-05-08 00:00:00+00:00,-100.0,12384.83,2019-05,rent
2019-05-08 00:00:00+00:00,-20.25,12405.08,2019-05,entertainment
2019-05-08 00:00:00+00:00,-0.7,12405.78,2019-05,savings
2019-05-08 00:00:00+00:00,-1.03,12406.81,2019-05,savings
2019-05-08 00:00:00+00:00,-31.9,12438.71,2019-05,groceries / food spend
2019-05-07 00:00:00+00:00,-77.86,12516.57,2019-05,bills and utilities
2019-05-07 00:00:00+00:00,-1.15,12517.72,2019-05,savings
2019-05-07 00:00:00+00:00,-70.0,12587.72,2019-05,transfer
2019-05-06 00:00:00+00:00,-28.25,12615.97,2019-05,bills and utilities
2019-05-06 00:00:00+00:00,22.42,12593.55,2019-05,taxes
2019-05-06 00:00:00+00:00,-12.89,12606.44,2019-05,groceries / food spend
2019-05-06 00:00:00+00:00,-50.0,12656.44,2019-05,bills and utilities
2019-05-06 00:00:00+00:00,-8.43,12664.87,2019-05,home and garden
2019-05-06 00:00:00+00:00,342.59,12322.28,2019-05,taxes
2019-05-06 00:00:00+00:00,137.6,12184.68,2019-05,transfer
2019-05-06 00:00:00+00:00,61.89,12122.79,2019-05,transfer
2019-05-06 00:00:00+00:00,-0.01,12122.8,2019-05,savings
2019-05-06 00:00:00+00:00,-3.78,12126.58,2019-05,shopping
2019-05-05 00:00:00+00:00,-91.49,12218.07,2019-05,transfer
2019-05-05 00:00:00+00:00,-1.87,12219.94,2019-05,savings
2019-05-05 00:00:00+00:00,-4.34,12224.28,2019-05,finances
2019-05-05 00:00:00+00:00,-6.12,12230.4,2019-05,shopping
2019-05-05 00:00:00+00:00,-23.15,12253.55,2019-05,transfer
2019-05-05 00:00:00+00:00,-16.81,12270.36,2019-05,finances
2019-05-05 00:00:00+00:00,-9.73,12280.09,2019-05,groceries / food spend
2019-05-05 00:00:00+00:00,-3.92,12284.01,2019-05,shopping
2019-05-04 00:00:00+00:00,10.0,12274.01,2019-05,transfer
2019-05-04 00:00:00+00:00,81.42,12192.59,2019-05,transfer
2019-05-04 00:00:00+00:00,100.97,12091.62,2019-05,transfer
2019-05-04 00:00:00+00:00,-2.12,12093.74,2019-05,transfer
2019-05-04 00:00:00+00:00,-3.98,12097.72,2019-05,shopping
2019-05-04 00:00:00+00:00,-3.07,12100.79,2019-05,finances
2019-05-04 00:00:00+00:00,-77.78,12178.57,2019-05,transfer
2019-05-04 00:00:00+00:00,156.95,12021.62,2019-05,transfer
2019-05-04 00:00:00+00:00,-3.59,12025.21,2019-05,business services
2019-05-04 00:00:00+00:00,49.43,11975.78,2019-05,transfer
2019-05-04 00:00:00+00:00,-130.0,12105.78,2019-05,rent
2019-05-03 00:00:00+00:00,0.89,12104.89,2019-05,transfer
2019-05-03 00:00:00+00:00,-0.45,12105.34,2019-05,savings
2019-05-03 00:00:00+00:00,163.92,11941.42,2019-05,transfer
2019-05-03 00:00:00+00:00,9.95,11931.47,2019-05,transfer
2019-05-03 00:00:00+00:00,-23.11,11954.58,2019-05,transport
2019-05-03 00:00:00+00:00,35.49,11919.09,2019-05,entertainment
2019-05-03 00:00:00+00:00,-0.01,11919.1,2019-05,savings
2019-05-03 00:00:00+00:00,-2.99,11922.09,2019-05,entertainment
2019-05-03 00:00:00+00:00,-30.0,11952.09,2019-05,shopping
2019-05-03 00:00:00+00:00,50.49,11901.6,2019-05,transfer
2019-05-03 00:00:00+00:00,-25.25,11926.85,2019-05,transfer
2019-05-03 00:00:00+00:00,-5.0,11931.85,2019-05,groceries / food spend
2019-05-02 00:00:00+00:00,-18.88,11950.73,2019-05,transfer
2019-05-02 00:00:00+00:00,-45.48,11996.21,2019-05,transfer
2019-05-02 00:00:00+00:00,5.53,11990.68,2019-05,transfer
2019-05-02 00:00:00+00:00,-0.68,11991.36,2019-05,savings
2019-05-01 00:00:00+00:00,-46.82,12038.18,2019-05,bills and utilities
2019-05-01 00:00:00+00:00,-0.01,12038.19,2019-05,fees and charges
2019-05-01 00:00:00+00:00,-227.0,12265.19,2019-05,transfer
2019-05-01 00:00:00+00:00,-39.99,12305.18,2019-05,groceries / food spend
2019-05-01 00:00:00+00:00,-0.01,12305.19,2019-05,finances
2019-05-01 00:00:00+00:00,-0.02,12305.21,2019-05,shopping
2019-05-01 00:00:00+00:00,0.0,12305.21,2019-05,shopping
2019-05-01 00:00:00+00:00,-0.01,12305.22,2019-05,groceries / food spend
2019-05-01 00:00:00+00:00,0.0,12305.22,2019-05,groceries / food spend
2019-05-01 00:00:00+00:00,-0.01,12305.23,2019-05,groceries / food spend
2019-05-01 00:00:00+00:00,-0.01,12305.24,2019-05,groceries / food spend
2019-05-01 00:00:00+00:00,-0.01,12305.25,2019-05,transport
2019-05-01 00:00:00+00:00,-200.0,12505.25,2019-05,restaurants / eating out / delivery
2019-05-01 00:00:00+00:00,-0.02,12505.27,2019-05,home and garden
2019-05-01 00:00:00+00:00,-0.01,12505.28,2019-05,fees and charges
2019-05-01 00:00:00+00:00,-0.01,12505.29,2019-05,transport
2019-05-01 00:00:00+00:00,-0.01,12505.3,2019-05,entertainment
2019-05-01 00:00:00+00:00,-0.01,12505.31,2019-05,fees and charges
2019-05-01 00:00:00+00:00,-23.99,12529.3,2019-05,groceries / food spend
2019-05-01 00:00:00+00:00,-20.91,12550.21,2019-05,transfer
2019-05-01 00:00:00+00:00,-11.09,12561.3,2019-05,business services
2019-05-01 00:00:00+00:00,-10.0,12571.3,2019-05,bills and utilities
2019-05-01 00:00:00+00:00,-9.78,12581.08,2019-05,finances
2019-05-01 00:00:00+00:00,-8.81,12589.89,2019-05,finances
2019-05-01 00:00:00+00:00,-8.44,12598.33,2019-05,bills and utilities
2019-04-28 00:00:00+00:00,664.14,11934.19,2019-04,transfer
2019-04-28 00:00:00+00:00,-36.59,11970.78,2019-04,shopping
2019-04-28 00:00:00+00:00,22.71,11948.07,2019-04,transfer
2019-04-28 00:00:00+00:00,-35.1,11983.17,2019-04,transfer
2019-04-28 00:00:00+00:00,21.81,11961.36,2019-04,taxes
2019-04-27 00:00:00+00:00,-7.93,11969.29,2019-04,transfer
2019-04-27 00:00:00+00:00,51.34,11917.95,2019-04,transfer
2019-04-27 00:00:00+00:00,14.99,11902.96,2019-04,transfer
2019-04-27 00:00:00+00:00,-20.56,11923.52,2019-04,transport
2019-04-27 00:00:00+00:00,-2.99,11926.51,2019-04,finances
2019-04-27 00:00:00+00:00,-23.62,11950.13,2019-04,groceries / food spend
2019-04-27 00:00:00+00:00,-15.21,11965.34,2019-04,shopping
2019-04-25 00:00:00+00:00,70.0,11895.34,2019-04,transfer
2019-04-25 00:00:00+00:00,-38.96,11934.3,2019-04,entertainment
2019-04-25 00:00:00+00:00,-5.55,11939.85,2019-04,transfer
2019-04-25 00:00:00+00:00,-0.43,11940.28,2019-04,savings
2019-04-25 00:00:00+00:00,-36.59,11976.87,2019-04,shopping
2019-04-25 00:00:00+00:00,-0.5,11977.37,2019-04,savings
2019-04-25 00:00:00+00:00,-10.5,11987.87,2019-04,entertainment
2019-04-23 00:00:00+00:00,-31.4,12019.27,2019-04,finances
2019-04-23 00:00:00+00:00,32.62,11986.65,2019-04,transfer
2019-04-23 00:00:00+00:00,-70.06,12056.71,2019-04,transfer
2019-04-23 00:00:00+00:00,-1.81,12058.52,2019-04,savings
2019-04-23 00:00:00+00:00,-4.95,12063.47,2019-04,transfer
2019-04-22 00:00:00+00:00,-5.0,12068.47,2019-04,shopping
2019-04-22 00:00:00+00:00,-0.01,12068.48,2019-04,savings
2019-04-22 00:00:00+00:00,-45.33,12113.81,2019-04,bills and utilities
2019-04-22 00:00:00+00:00,-36.59,12150.4,2019-04,shopping
2019-04-22 00:00:00+00:00,-36.59,12186.99,2019-04,finances
2019-04-20 00:00:00+00:00,-150.0,12336.99,2019-04,rent
2019-04-20 00:00:00+00:00,22.42,12314.57,2019-04,taxes
2019-04-20 00:00:00+00:00,-550.0,12864.57,2019-04,business services
2019-04-20 00:00:00+00:00,366.13,12498.44,2019-04,taxes
2019-04-19 00:00:00+00:00,-7.99,12506.43,2019-04,shopping
2019-04-19 00:00:00+00:00,1450.42,11056.01,2019-04,salary
2019-04-18 00:00:00+00:00,75.56,10980.45,2019-04,finances
2019-04-17 00:00:00+00:00,50.75,10929.7,2019-04,transfer
2019-04-17 00:00:00+00:00,-12.73,10942.43,2019-04,finances
2019-04-17 00:00:00+00:00,-41.16,10983.59,2019-04,finances
2019-04-17 00:00:00+00:00,-20.0,11003.59,2019-04,transport
2019-04-17 00:00:00+00:00,-0.63,11004.22,2019-04,savings
2019-04-17 00:00:00+00:00,-13.54,11017.76,2019-04,groceries / food spend
2019-04-15 00:00:00+00:00,-32.0,11049.76,2019-04,groceries / food spend
2019-04-15 00:00:00+00:00,-0.55,11050.31,2019-04,savings
2019-04-15 00:00:00+00:00,-15.45,11065.76,2019-04,shopping
2019-04-15 00:00:00+00:00,-0.55,11066.31,2019-04,savings
2019-04-15 00:00:00+00:00,-0.7,11067.01,2019-04,shopping
2019-04-15 00:00:00+00:00,-13.8,11080.81,2019-04,shopping
2019-04-14 00:00:00+00:00,-2.0,11082.81,2019-04,entertainment
2019-04-14 00:00:00+00:00,-13.14,11095.95,2019-04,entertainment
2019-04-14 00:00:00+00:00,59.76,11036.19,2019-04,entertainment
2019-04-12 00:00:00+00:00,-0.42,11036.61,2019-04,savings
2019-04-12 00:00:00+00:00,-23.11,11059.72,2019-04,transport
2019-04-11 00:00:00+00:00,49.84,11009.88,2019-04,finances
2019-04-11 00:00:00+00:00,64.29,10945.59,2019-04,transfer
2019-04-11 00:00:00+00:00,22.24,10923.35,2019-04,taxes
2019-04-11 00:00:00+00:00,-17.0,10940.35,2019-04,holidays
2019-04-10 00:00:00+00:00,-29.56,10969.91,2019-04,finances
2019-04-10 00:00:00+00:00,-2.1,10972.01,2019-04,groceries / food spend
2019-04-10 00:00:00+00:00,40.0,10932.01,2019-04,transfer
2019-04-10 00:00:00+00:00,66.3,10865.71,2019-04,finances
2019-04-10 00:00:00+00:00,-30.0,10895.71,2019-04,transfer
2019-04-10 00:00:00+00:00,-24.5,10920.21,2019-04,bills and utilities
2019-04-09 00:00:00+00:00,-23.62,10943.83,2019-04,transport
2019-04-09 00:00:00+00:00,-20.56,10964.39,2019-04,taxes
2019-04-09 00:00:00+00:00,-0.39,10964.78,2019-04,savings
2019-04-09 00:00:00+00:00,52.92,10911.86,2019-04,transfer
2019-04-08 00:00:00+00:00,-0.01,10911.87,2019-04,savings
2019-04-08 00:00:00+00:00,22.42,10889.45,2019-04,taxes
2019-04-08 00:00:00+00:00,-15.8,10905.25,2019-04,fees and charges
2019-04-08 00:00:00+00:00,-100.0,11005.25,2019-04,rent
2019-04-08 00:00:00+00:00,-8.26,11013.51,2019-04,entertainment
2019-04-08 00:00:00+00:00,-0.62,11014.13,2019-04,savings
2019-04-08 00:00:00+00:00,-1.08,11015.21,2019-04,savings
2019-04-08 00:00:00+00:00,-7.79,11023.0,2019-04,groceries / food spend
2019-04-07 00:00:00+00:00,-82.37,11105.37,2019-04,bills and utilities
2019-04-07 00:00:00+00:00,-1.15,11106.52,2019-04,savings
2019-04-07 00:00:00+00:00,-70.0,11176.52,2019-04,transfer
2019-04-06 00:00:00+00:00,-25.47,11201.99,2019-04,bills and utilities
2019-04-06 00:00:00+00:00,22.42,11179.57,2019-04,taxes
2019-04-06 00:00:00+00:00,-12.89,11192.46,2019-04,groceries / food spend
2019-04-06 00:00:00+00:00,-50.0,11242.46,2019-04,bills and utilities
2019-04-06 00:00:00+00:00,4.56,11237.9,2019-04,home and garden
2019-04-06 00:00:00+00:00,346.35,10891.55,2019-04,taxes
2019-04-06 00:00:00+00:00,137.6,10753.95,2019-04,transfer
2019-04-06 00:00:00+00:00,61.89,10692.06,2019-04,transfer
2019-04-06 00:00:00+00:00,-0.01,10692.07,2019-04,savings
2019-04-06 00:00:00+00:00,-4.88,10696.95,2019-04,shopping
2019-04-05 00:00:00+00:00,-60.0,10756.95,2019-04,transfer
2019-04-05 00:00:00+00:00,-1.89,10758.84,2019-04,savings
2019-04-05 00:00:00+00:00,-2.4,10761.24,2019-04,finances
2019-04-05 00:00:00+00:00,-7.99,10769.23,2019-04,shopping
2019-04-05 00:00:00+00:00,-16.93,10786.16,2019-04,transfer
2019-04-05 00:00:00+00:00,-12.73,10798.89,2019-04,finances
2019-04-05 00:00:00+00:00,-6.37,10805.26,2019-04,groceries / food spend
2019-04-05 00:00:00+00:00,-7.63,10812.89,2019-04,shopping
2019-04-04 00:00:00+00:00,10.0,10802.89,2019-04,transfer
2019-04-04 00:00:00+00:00,16.35,10786.54,2019-04,transfer
2019-04-04 00:00:00+00:00,145.15,10641.39,2019-04,transfer
2019-04-04 00:00:00+00:00,-21.2,10662.59,2019-04,transfer
2019-04-04 00:00:00+00:00,-5.0,10667.59,2019-04,shopping
2019-04-04 00:00:00+00:00,-3.07,10670.66,2019-04,finances
2019-04-04 00:00:00+00:00,-100.0,10770.66,2019-04,transfer
2019-04-04 00:00:00+00:00,100.0,10670.66,2019-04,transfer
2019-04-04 00:00:00+00:00,-3.59,10674.25,2019-04,business services
2019-04-04 00:00:00+00:00,25.0,10649.25,2019-04,transfer
2019-04-04 00:00:00+00:00,-130.0,10779.25,2019-04,rent
2019-04-03 00:00:00+00:00,0.89,10778.36,2019-04,transfer
2019-04-03 00:00:00+00:00,-0.41,10778.77,2019-04,savings
2019-04-03 00:00:00+00:00,132.02,10646.75,2019-04,transfer
2019-04-03 00:00:00+00:00,7.0,10639.75,2019-04,transfer
2019-04-03 00:00:00+00:00,-23.11,10662.86,2019-04,transport
2019-04-03 00:00:00+00:00,35.49,10627.37,2019-04,entertainment
2019-04-03 00:00:00+00:00,-0.01,10627.38,2019-04,savings
2019-04-03 00:00:00+00:00,-4.34,10631.72,2019-04,entertainment
2019-04-03 00:00:00+00:00,-15.16,10646.88,2019-04,shopping
2019-04-03 00:00:00+00:00,40.0,10606.88,2019-04,transfer
2019-04-03 00:00:00+00:00,-74.99,10681.87,2019-04,transfer
2019-04-03 00:00:00+00:00,-5.0,10686.87,2019-04,groceries / food spend
2019-04-02 00:00:00+00:00,32.46,10654.41,2019-04,transfer
2019-04-02 00:00:00+00:00,-25.75,10680.16,2019-04,transfer
2019-04-02 00:00:00+00:00,10.0,10670.16,2019-04,transfer
2019-04-02 00:00:00+00:00,-0.59,10670.75,2019-04,savings
2019-04-01 00:00:00+00:00,-46.82,10717.57,2019-04,bills and utilities
2019-04-01 00:00:00+00:00,-0.0,10717.57,2019-04,fees and charges
2019-04-01 00:00:00+00:00,-149.22,10866.79,2019-04,transfer
2019-04-01 00:00:00+00:00,20.46,10846.33,2019-04,groceries / food spend
2019-04-01 00:00:00+00:00,-0.01,10846.34,2019-04,finances
2019-04-01 00:00:00+00:00,-0.01,10846.35,2019-04,shopping
2019-04-01 00:00:00+00:00,-0.01,10846.36,2019-04,shopping
2019-04-01 00:00:00+00:00,-0.0,10846.36,2019-04,groceries / food spend
2019-04-01 00:00:00+00:00,-0.01,10846.37,2019-04,groceries / food spend
2019-04-01 00:00:00+00:00,-0.01,10846.38,2019-04,groceries / food spend
2019-04-01 00:00:00+00:00,-0.01,10846.39,2019-04,groceries / food spend
2019-04-01 00:00:00+00:00,-0.0,10846.39,2019-04,transport
2019-04-01 00:00:00+00:00,-200.0,11046.39,2019-04,restaurants / eating out / delivery
2019-04-01 00:00:00+00:00,-0.02,11046.41,2019-04,home and garden
2019-04-01 00:00:00+00:00,-0.01,11046.42,2019-04,fees and charges
2019-04-01 00:00:00+00:00,-0.01,11046.43,2019-04,transport
2019-04-01 00:00:00+00:00,-0.01,11046.44,2019-04,entertainment
2019-04-01 00:00:00+00:00,-0.02,11046.46,2019-04,fees and charges
2019-04-01 00:00:00+00:00,-35.29,11081.75,2019-04,groceries / food spend
2019-04-01 00:00:00+00:00,-20.91,11102.66,2019-04,transfer
2019-04-01 00:00:00+00:00,-6.52,11109.18,2019-04,business services
2019-04-01 00:00:00+00:00,-9.03,11118.21,2019-04,bills and utilities
2019-04-01 00:00:00+00:00,-10.0,11128.21,2019-04,finances
2019-04-01 00:00:00+00:00,-12.2,11140.41,2019-04,finances
2019-04-01 00:00:00+00:00,-9.95,11150.36,2019-04,bills and utilities
2019-03-28 00:00:00+00:00,272.09,10878.27,2019-03,transfer
2019-03-28 00:00:00+00:00,-54.28,10932.55,2019-03,shopping
2019-03-28 00:00:00+00:00,24.39,10908.16,2019-03,transfer
2019-03-28 00:00:00+00:00,-28.73,10936.89,2019-03,transfer
2019-03-28 00:00:00+00:00,21.96,10914.93,2019-03,taxes
2019-03-27 00:00:00+00:00,-6.75,10921.68,2019-03,transfer
2019-03-27 00:00:00+00:00,46.15,10875.53,2019-03,transfer
2019-03-27 00:00:00+00:00,15.86,10859.67,2019-03,transfer
2019-03-27 00:00:00+00:00,-18.49,10878.16,2019-03,transport
2019-03-27 00:00:00+00:00,-2.99,10881.15,2019-03,finances
2019-03-27 00:00:00+00:00,-3.02,10884.17,2019-03,groceries / food spend
2019-03-27 00:00:00+00:00,-12.16,10896.33,2019-03,shopping
2019-03-25 00:00:00+00:00,70.0,10826.33,2019-03,transfer
2019-03-25 00:00:00+00:00,-24.5,10850.83,2019-03,entertainment
2019-03-25 00:00:00+00:00,2.44,10848.39,2019-03,transfer
2019-03-25 00:00:00+00:00,-0.41,10848.8,2019-03,savings
2019-03-25 00:00:00+00:00,-36.59,10885.39,2019-03,shopping
2019-03-25 00:00:00+00:00,-0.5,10885.89,2019-03,savings
2019-03-25 00:00:00+00:00,-10.5,10896.39,2019-03,entertainment
2019-03-23 00:00:00+00:00,-30.0,10926.39,2019-03,finances
2019-03-23 00:00:00+00:00,32.5,10893.89,2019-03,transfer
2019-03-23 00:00:00+00:00,-100.0,10993.89,2019-03,transfer
2019-03-23 00:00:00+00:00,-1.3,10995.19,2019-03,savings
2019-03-23 00:00:00+00:00,-20.0,11015.19,2019-03,transfer
2019-03-22 00:00:00+00:00,-6.06,11021.25,2019-03,shopping
2019-03-22 00:00:00+00:00,-0.01,11021.26,2019-03,savings
2019-03-22 00:00:00+00:00,-39.25,11060.51,2019-03,bills and utilities
2019-03-22 00:00:00+00:00,-36.59,11097.1,2019-03,shopping
2019-03-22 00:00:00+00:00,-36.59,11133.69,2019-03,finances
2019-03-20 00:00:00+00:00,-150.0,11283.69,2019-03,rent
2019-03-20 00:00:00+00:00,21.91,11261.78,2019-03,taxes
2019-03-20 00:00:00+00:00,-550.0,11811.78,2019-03,business services
2019-03-20 00:00:00+00:00,345.13,11466.65,2019-03,taxes
2019-03-19 00:00:00+00:00,-5.36,11472.01,2019-03,shopping
2019-03-19 00:00:00+00:00,1450.42,10021.59,2019-03,salary
2019-03-18 00:00:00+00:00,82.21,9939.38,2019-03,finances
2019-03-17 00:00:00+00:00,137.6,9801.78,2019-03,transfer
2019-03-17 00:00:00+00:00,-12.73,9814.51,2019-03,finances
2019-03-17 00:00:00+00:00,-49.34,9863.85,2019-03,finances
2019-03-17 00:00:00+00:00,-29.47,9893.32,2019-03,transport
2019-03-17 00:00:00+00:00,-0.63,9893.95,2019-03,savings
2019-03-17 00:00:00+00:00,-6.37,9900.32,2019-03,groceries / food spend
2019-03-15 00:00:00+00:00,-19.49,9919.81,2019-03,groceries / food spend
2019-03-15 00:00:00+00:00,-0.5,9920.31,2019-03,savings
2019-03-15 00:00:00+00:00,-20.27,9940.58,2019-03,shopping
2019-03-15 00:00:00+00:00,-0.49,9941.07,2019-03,savings
2019-03-15 00:00:00+00:00,-1.21,9942.28,2019-03,shopping
2019-03-15 00:00:00+00:00,-11.86,9954.14,2019-03,shopping
2019-03-14 00:00:00+00:00,-0.65,9954.79,2019-03,entertainment
2019-03-14 00:00:00+00:00,-10.92,9965.71,2019-03,entertainment
2019-03-14 00:00:00+00:00,33.55,9932.16,2019-03,entertainment
2019-03-12 00:00:00+00:00,-0.41,9932.57,2019-03,savings
2019-03-12 00:00:00+00:00,-20.7,9953.27,2019-03,transport
2019-03-11 00:00:00+00:00,50.0,9903.27,2019-03,finances
2019-03-11 00:00:00+00:00,50.0,9853.27,2019-03,transfer
2019-03-11 00:00:00+00:00,21.85,9831.42,2019-03,taxes
2019-03-11 00:00:00+00:00,-10.04,9841.46,2019-03,holidays
2019-03-10 00:00:00+00:00,-42.64,9884.1,2019-03,finances
2019-03-10 00:00:00+00:00,-5.06,9889.16,2019-03,groceries / food spend
2019-03-10 00:00:00+00:00,40.0,9849.16,2019-03,transfer
2019-03-10 00:00:00+00:00,50.36,9798.8,2019-03,finances
2019-03-10 00:00:00+00:00,-30.0,9828.8,2019-03,transfer
2019-03-10 00:00:00+00:00,-24.5,9853.3,2019-03,bills and utilities
2019-03-09 00:00:00+00:00,-22.44,9875.74,2019-03,transport
2019-03-09 00:00:00+00:00,-19.79,9895.53,2019-03,taxes
2019-03-09 00:00:00+00:00,-0.41,9895.94,2019-03,savings
2019-03-09 00:00:00+00:00,79.04,9816.9,2019-03,transfer
2019-03-08 00:00:00+00:00,-0.01,9816.91,2019-03,savings
2019-03-08 00:00:00+00:00,23.68,9793.23,2019-03,taxes
2019-03-08 00:00:00+00:00,-11.35,9804.58,2019-03,fees and charges
2019-03-08 00:00:00+00:00,-100.0,9904.58,2019-03,rent
2019-03-08 00:00:00+00:00,-11.22,9915.8,2019-03,entertainment
2019-03-08 00:00:00+00:00,-0.59,9916.39,2019-03,savings
2019-03-08 00:00:00+00:00,-1.06,9917.45,2019-03,savings
2019-03-08 00:00:00+00:00,-44.52,9961.97,2019-03,groceries / food spend
2019-03-07 00:00:00+00:00,-79.92,10041.89,2019-03,bills and utilities
2019-03-07 00:00:00+00:00,-1.41,10043.3,2019-03,savings
2019-03-07 00:00:00+00:00,-114.64,10157.94,2019-03,transfer
2019-03-06 00:00:00+00:00,-27.57,10185.51,2019-03,bills and utilities
2019-03-06 00:00:00+00:00,22.28,10163.23,2019-03,taxes
2019-03-06 00:00:00+00:00,-20.87,10184.1,2019-03,groceries / food spend
2019-03-06 00:00:00+00:00,-50.0,10234.1,2019-03,bills and utilities
2019-03-06 00:00:00+00:00,-17.5,10251.6,2019-03,home and garden
2019-03-06 00:00:00+00:00,346.35,9905.25,2019-03,taxes
2019-03-06 00:00:00+00:00,137.6,9767.65,2019-03,transfer
2019-03-06 00:00:00+00:00,61.89,9705.76,2019-03,transfer
2019-03-06 00:00:00+00:00,-0.01,9705.77,2019-03,savings
2019-03-06 00:00:00+00:00,-3.24,9709.01,2019-03,shopping
2019-03-05 00:00:00+00:00,-60.0,9769.01,2019-03,transfer
2019-03-05 00:00:00+00:00,-1.43,9770.44,2019-03,savings
2019-03-05 00:00:00+00:00,-7.34,9777.78,2019-03,finances
2019-03-05 00:00:00+00:00,-10.19,9787.97,2019-03,shopping
2019-03-05 00:00:00+00:00,-23.15,9811.12,2019-03,transfer
2019-03-05 00:00:00+00:00,-12.73,9823.85,2019-03,finances
2019-03-05 00:00:00+00:00,-6.37,9830.22,2019-03,groceries / food spend
2019-03-05 00:00:00+00:00,-19.47,9849.69,2019-03,shopping
2019-03-04 00:00:00+00:00,10.0,9839.69,2019-03,transfer
2019-03-04 00:00:00+00:00,134.33,9705.36,2019-03,transfer
2019-03-04 00:00:00+00:00,90.8,9614.56,2019-03,transfer
2019-03-04 00:00:00+00:00,-20.0,9634.56,2019-03,transfer
2019-03-04 00:00:00+00:00,-2.03,9636.59,2019-03,shopping
2019-03-04 00:00:00+00:00,-3.07,9639.66,2019-03,finances
2019-03-04 00:00:00+00:00,-113.18,9752.84,2019-03,transfer
2019-03-04 00:00:00+00:00,100.0,9652.84,2019-03,transfer
2019-03-04 00:00:00+00:00,-3.94,9656.78,2019-03,business services
2019-03-04 00:00:00+00:00,25.0,9631.78,2019-03,transfer
2019-03-04 00:00:00+00:00,-130.0,9761.78,2019-03,rent
2019-03-03 00:00:00+00:00,0.36,9761.42,2019-03,transfer
2019-03-03 00:00:00+00:00,-0.43,9761.85,2019-03,savings
2019-03-03 00:00:00+00:00,182.72,9579.13,2019-03,transfer
2019-03-03 00:00:00+00:00,7.0,9572.13,2019-03,transfer
2019-03-03 00:00:00+00:00,1.27,9570.86,2019-03,transport
2019-03-03 00:00:00+00:00,35.49,9535.37,2019-03,entertainment
2019-03-03 00:00:00+00:00,-0.01,9535.38,2019-03,savings
2019-03-03 00:00:00+00:00,-4.5,9539.88,2019-03,entertainment
2019-03-03 00:00:00+00:00,-46.77,9586.65,2019-03,shopping
2019-03-03 00:00:00+00:00,40.0,9546.65,2019-03,transfer
2019-03-03 00:00:00+00:00,-40.0,9586.65,2019-03,transfer
2019-03-03 00:00:00+00:00,-5.0,9591.65,2019-03,groceries / food spend
2019-03-02 00:00:00+00:00,30.0,9561.65,2019-03,transfer
2019-03-02 00:00:00+00:00,-37.73,9599.38,2019-03,transfer
2019-03-02 00:00:00+00:00,10.0,9589.38,2019-03,transfer
2019-03-02 00:00:00+00:00,-0.59,9589.97,2019-03,savings
2019-03-01 00:00:00+00:00,-46.82,9636.79,2019-03,bills and utilities
2019-03-01 00:00:00+00:00,-0.01,9636.8,2019-03,fees and charges
2019-03-01 00:00:00+00:00,-227.0,9863.8,2019-03,transfer
2019-03-01 00:00:00+00:00,-12.29,9876.09,2019-03,groceries / food spend
2019-03-01 00:00:00+00:00,-0.01,9876.1,2019-03,finances
2019-03-01 00:00:00+00:00,-0.01,9876.11,2019-03,shopping
2019-03-01 00:00:00+00:00,-0.0,9876.11,2019-03,shopping
2019-03-01 00:00:00+00:00,-0.01,9876.12,2019-03,groceries / food spend
2019-03-01 00:00:00+00:00,-0.01,9876.13,2019-03,groceries / food spend
2019-03-01 00:00:00+00:00,-0.0,9876.13,2019-03,groceries / food spend
2019-03-01 00:00:00+00:00,-0.01,9876.14,2019-03,groceries / food spend
2019-03-01 00:00:00+00:00,-0.01,9876.15,2019-03,transport
2019-03-01 00:00:00+00:00,-200.0,10076.15,2019-03,restaurants / eating out / delivery
2019-03-01 00:00:00+00:00,-0.01,10076.16,2019-03,home and garden
2019-03-01 00:00:00+00:00,-0.01,10076.17,2019-03,fees and charges
2019-03-01 00:00:00+00:00,-0.01,10076.18,2019-03,transport
2019-03-01 00:00:00+00:00,-0.02,10076.2,2019-03,entertainment
2019-03-01 00:00:00+00:00,-0.01,10076.21,2019-03,fees and charges
2019-03-01 00:00:00+00:00,-0.23,10076.44,2019-03,groceries / food spend
2019-03-01 00:00:00+00:00,-20.91,10097.35,2019-03,transfer
2019-03-01 00:00:00+00:00,-8.93,10106.28,2019-03,business services
2019-03-01 00:00:00+00:00,-10.0,10116.28,2019-03,bills and utilities
2019-03-01 00:00:00+00:00,-6.69,10122.97,2019-03,finances
2019-03-01 00:00:00+00:00,-9.37,10132.34,2019-03,finances
2019-03-01 00:00:00+00:00,-10.0,10142.34,2019-03,bills and utilities
2019-02-28 00:00:00+00:00,420.0,9722.34,2019-02,transfer
2019-02-28 00:00:00+00:00,-36.59,9758.93,2019-02,shopping
2019-02-28 00:00:00+00:00,40.0,9718.93,2019-02,transfer
2019-02-28 00:00:00+00:00,-32.72,9751.65,2019-02,transfer
2019-02-28 00:00:00+00:00,22.42,9729.23,2019-02,taxes
2019-02-27 00:00:00+00:00,-7.42,9736.65,2019-02,transfer
2019-02-27 00:00:00+00:00,64.28,9672.37,2019-02,transfer
2019-02-27 00:00:00+00:00,12.59,9659.78,2019-02,transfer
2019-02-27 00:00:00+00:00,-20.56,9680.34,2019-02,transport
2019-02-27 00:00:00+00:00,-3.19,9683.53,2019-02,finances
2019-02-27 00:00:00+00:00,-14.94,9698.47,2019-02,groceries / food spend
2019-02-27 00:00:00+00:00,-3.15,9701.62,2019-02,shopping
2019-02-25 00:00:00+00:00,70.0,9631.62,2019-02,transfer
2019-02-25 00:00:00+00:00,-24.5,9656.12,2019-02,entertainment
2019-02-25 00:00:00+00:00,-7.25,9663.37,2019-02,transfer
2019-02-25 00:00:00+00:00,-0.41,9663.78,2019-02,savings
2019-02-25 00:00:00+00:00,-36.59,9700.37,2019-02,shopping
2019-02-25 00:00:00+00:00,-0.48,9700.85,2019-02,savings
2019-02-25 00:00:00+00:00,-10.5,9711.35,2019-02,entertainment
2019-02-23 00:00:00+00:00,-30.0,9741.35,2019-02,finances
2019-02-23 00:00:00+00:00,37.69,9703.66,2019-02,transfer
2019-02-23 00:00:00+00:00,-100.0,9803.66,2019-02,transfer
2019-02-23 00:00:00+00:00,-1.55,9805.21,2019-02,savings
2019-02-23 00:00:00+00:00,-20.0,9825.21,2019-02,transfer
2019-02-22 00:00:00+00:00,-5.0,9830.21,2019-02,shopping
2019-02-22 00:00:00+00:00,-0.01,9830.22,2019-02,savings
2019-02-22 00:00:00+00:00,-39.25,9869.47,2019-02,bills and utilities
2019-02-22 00:00:00+00:00,-75.31,9944.78,2019-02,shopping
2019-02-22 00:00:00+00:00,-35.23,9980.01,2019-02,finances
2019-02-20 00:00:00+00:00,-150.0,10130.01,2019-02,rent
2019-02-20 00:00:00+00:00,22.62,10107.39,2019-02,taxes
2019-02-20 00:00:00+00:00,-550.0,10657.39,2019-02,business services
2019-02-20 00:00:00+00:00,345.13,10312.26,2019-02,taxes
2019-02-19 00:00:00+00:00,-7.99,10320.25,2019-02,shopping
2019-02-19 00:00:00+00:00,1450.42,8869.83,2019-02,salary
2019-02-18 00:00:00+00:00,82.21,8787.62,2019-02,finances
2019-02-17 00:00:00+00:00,137.6,8650.02,2019-02,transfer
2019-02-17 00:00:00+00:00,-12.8,8662.82,2019-02,finances
2019-02-17 00:00:00+00:00,-32.83,8695.65,2019-02,finances
2019-02-17 00:00:00+00:00,-16.61,8712.26,2019-02,transport
2019-02-17 00:00:00+00:00,-0.63,8712.89,2019-02,savings
2019-02-17 00:00:00+00:00,-6.37,8719.26,2019-02,groceries / food spend
2019-02-15 00:00:00+00:00,-32.0,8751.26,2019-02,groceries / food spend
2019-02-15 00:00:00+00:00,-0.55,8751.81,2019-02,savings
2019-02-15 00:00:00+00:00,-15.45,8767.26,2019-02,shopping
2019-02-15 00:00:00+00:00,-0.5,8767.76,2019-02,savings
2019-02-15 00:00:00+00:00,-3.59,8771.35,2019-02,shopping
2019-02-15 00:00:00+00:00,-10.0,8781.35,2019-02,shopping
2019-02-14 00:00:00+00:00,-5.01,8786.36,2019-02,entertainment
2019-02-14 00:00:00+00:00,-15.06,8801.42,2019-02,entertainment
2019-02-14 00:00:00+00:00,79.34,8722.08,2019-02,entertainment
2019-02-12 00:00:00+00:00,-0.41,8722.49,2019-02,savings
2019-02-12 00:00:00+00:00,-23.11,8745.6,2019-02,transport
2019-02-11 00:00:00+00:00,50.0,8695.6,2019-02,finances
2019-02-11 00:00:00+00:00,50.0,8645.6,2019-02,transfer
2019-02-11 00:00:00+00:00,20.9,8624.7,2019-02,taxes
2019-02-11 00:00:00+00:00,-16.67,8641.37,2019-02,holidays
2019-02-10 00:00:00+00:00,-40.0,8681.37,2019-02,finances
2019-02-10 00:00:00+00:00,-7.39,8688.76,2019-02,groceries / food spend
2019-02-10 00:00:00+00:00,40.0,8648.76,2019-02,transfer
2019-02-10 00:00:00+00:00,60.75,8588.01,2019-02,finances
2019-02-10 00:00:00+00:00,-25.6,8613.61,2019-02,transfer
2019-02-10 00:00:00+00:00,-24.5,8638.11,2019-02,bills and utilities
2019-02-09 00:00:00+00:00,-23.62,8661.73,2019-02,transport
2019-02-09 00:00:00+00:00,-20.56,8682.29,2019-02,taxes
2019-02-09 00:00:00+00:00,-0.42,8682.71,2019-02,savings
2019-02-09 00:00:00+00:00,70.0,8612.71,2019-02,transfer
2019-02-08 00:00:00+00:00,-0.01,8612.72,2019-02,savings
2019-02-08 00:00:00+00:00,24.01,8588.71,2019-02,taxes
2019-02-08 00:00:00+00:00,-14.99,8603.7,2019-02,fees and charges
2019-02-08 00:00:00+00:00,-100.0,8703.7,2019-02,rent
2019-02-08 00:00:00+00:00,-13.79,8717.49,2019-02,entertainment
2019-02-08 00:00:00+00:00,-0.55,8718.04,2019-02,savings
2019-02-08 00:00:00+00:00,-1.04,8719.08,2019-02,savings
2019-02-08 00:00:00+00:00,-24.78,8743.86,2019-02,groceries / food spend
2019-02-07 00:00:00+00:00,-75.64,8819.5,2019-02,bills and utilities
2019-02-07 00:00:00+00:00,-1.11,8820.61,2019-02,savings
2019-02-07 00:00:00+00:00,-85.2,8905.81,2019-02,transfer
2019-02-06 00:00:00+00:00,-28.25,8934.06,2019-02,bills and utilities
2019-02-06 00:00:00+00:00,22.42,8911.64,2019-02,taxes
2019-02-06 00:00:00+00:00,-12.89,8924.53,2019-02,groceries / food spend
2019-02-06 00:00:00+00:00,-50.0,8974.53,2019-02,bills and utilities
2019-02-06 00:00:00+00:00,-4.18,8978.71,2019-02,home and garden
2019-02-06 00:00:00+00:00,346.35,8632.36,2019-02,taxes
2019-02-06 00:00:00+00:00,137.6,8494.76,2019-02,transfer
2019-02-06 00:00:00+00:00,61.89,8432.87,2019-02,transfer
2019-02-06 00:00:00+00:00,-0.01,8432.88,2019-02,savings
2019-02-06 00:00:00+00:00,-4.61,8437.49,2019-02,shopping
2019-02-05 00:00:00+00:00,-83.47,8520.96,2019-02,transfer
2019-02-05 00:00:00+00:00,-1.89,8522.85,2019-02,savings
2019-02-05 00:00:00+00:00,-5.79,8528.64,2019-02,finances
2019-02-05 00:00:00+00:00,-7.99,8536.63,2019-02,shopping
2019-02-05 00:00:00+00:00,-27.67,8564.3,2019-02,transfer
2019-02-05 00:00:00+00:00,-12.73,8577.03,2019-02,finances
2019-02-05 00:00:00+00:00,-3.24,8580.27,2019-02,groceries / food spend
2019-02-05 00:00:00+00:00,-20.0,8600.27,2019-02,shopping
2019-02-04 00:00:00+00:00,10.0,8590.27,2019-02,transfer
2019-02-04 00:00:00+00:00,48.48,8541.79,2019-02,transfer
2019-02-04 00:00:00+00:00,59.17,8482.62,2019-02,transfer
2019-02-04 00:00:00+00:00,-23.05,8505.67,2019-02,transfer
2019-02-04 00:00:00+00:00,-5.0,8510.67,2019-02,shopping
2019-02-04 00:00:00+00:00,-1.53,8512.2,2019-02,finances
2019-02-04 00:00:00+00:00,-100.0,8612.2,2019-02,transfer
2019-02-04 00:00:00+00:00,100.0,8512.2,2019-02,transfer
2019-02-04 00:00:00+00:00,-1.06,8513.26,2019-02,business services
2019-02-04 00:00:00+00:00,25.0,8488.26,2019-02,transfer
2019-02-04 00:00:00+00:00,-130.0,8618.26,2019-02,rent
2019-02-03 00:00:00+00:00,0.89,8617.37,2019-02,transfer
2019-02-03 00:00:00+00:00,-0.41,8617.78,2019-02,savings
2019-02-03 00:00:00+00:00,58.1,8559.68,2019-02,transfer
2019-02-03 00:00:00+00:00,4.35,8555.33,2019-02,transfer
2019-02-03 00:00:00+00:00,-23.45,8578.78,2019-02,transport
2019-02-03 00:00:00+00:00,35.49,8543.29,2019-02,entertainment
2019-02-03 00:00:00+00:00,-0.01,8543.3,2019-02,savings
2019-02-03 00:00:00+00:00,-5.43,8548.73,2019-02,entertainment
2019-02-03 00:00:00+00:00,-15.94,8564.67,2019-02,shopping
2019-02-03 00:00:00+00:00,40.0,8524.67,2019-02,transfer
2019-02-03 00:00:00+00:00,-40.0,8564.67,2019-02,transfer
2019-02-03 00:00:00+00:00,-5.0,8569.67,2019-02,groceries / food spend
2019-02-02 00:00:00+00:00,29.4,8540.27,2019-02,transfer
2019-02-02 00:00:00+00:00,-30.0,8570.27,2019-02,transfer
2019-02-02 00:00:00+00:00,10.0,8560.27,2019-02,transfer
2019-02-02 00:00:00+00:00,-0.59,8560.86,2019-02,savings
2019-02-01 00:00:00+00:00,-46.82,8607.68,2019-02,bills and utilities
2019-02-01 00:00:00+00:00,-0.02,8607.7,2019-02,fees and charges
2019-02-01 00:00:00+00:00,-405.99,9013.69,2019-02,transfer
2019-02-01 00:00:00+00:00,-39.99,9053.68,2019-02,groceries / food spend
2019-02-01 00:00:00+00:00,-0.01,9053.69,2019-02,finances
2019-02-01 00:00:00+00:00,-0.0,9053.69,2019-02,shopping
2019-02-01 00:00:00+00:00,-0.01,9053.7,2019-02,shopping
2019-02-01 00:00:00+00:00,-0.01,9053.71,2019-02,groceries / food spend
2019-02-01 00:00:00+00:00,-0.01,9053.72,2019-02,groceries / food spend
2019-02-01 00:00:00+00:00,-0.01,9053.73,2019-02,groceries / food spend
2019-02-01 00:00:00+00:00,-0.01,9053.74,2019-02,groceries / food spend
2019-02-01 00:00:00+00:00,-0.01,9053.75,2019-02,transport
2019-02-01 00:00:00+00:00,-200.0,9253.75,2019-02,restaurants / eating out / delivery
2019-02-01 00:00:00+00:00,-0.01,9253.76,2019-02,home and garden
2019-02-01 00:00:00+00:00,-0.01,9253.77,2019-02,fees and charges
2019-02-01 00:00:00+00:00,-0.01,9253.78,2019-02,transport
2019-02-01 00:00:00+00:00,-0.01,9253.79,2019-02,entertainment
2019-02-01 00:00:00+00:00,-0.01,9253.8,2019-02,fees and charges
2019-02-01 00:00:00+00:00,-23.99,9277.79,2019-02,groceries / food spend
2019-02-01 00:00:00+00:00,-20.91,9298.7,2019-02,transfer
2019-02-01 00:00:00+00:00,-14.42,9313.12,2019-02,business services
2019-02-01 00:00:00+00:00,-10.0,9323.12,2019-02,bills and utilities
2019-02-01 00:00:00+00:00,-12.02,9335.14,2019-02,finances
2019-02-01 00:00:00+00:00,-10.81,9345.95,2019-02,finances
2019-02-01 00:00:00+00:00,-9.21,9355.16,2019-02,bills and utilities
2019-01-28 00:00:00+00:00,420.0,8935.16,2019-01,transfer
2019-01-28 00:00:00+00:00,-10.05,8945.21,2019-01,shopping
2019-01-28 00:00:00+00:00,40.0,8905.21,2019-01,transfer
2019-01-28 00:00:00+00:00,-39.6,8944.81,2019-01,transfer
2019-01-28 00:00:00+00:00,25.47,8919.34,2019-01,taxes
2019-01-27 00:00:00+00:00,-7.93,8927.27,2019-01,transfer
2019-01-27 00:00:00+00:00,49.15,8878.12,2019-01,transfer
2019-01-27 00:00:00+00:00,15.86,8862.26,2019-01,transfer
2019-01-27 00:00:00+00:00,-20.56,8882.82,2019-01,transport
2019-01-27 00:00:00+00:00,-2.99,8885.81,2019-01,finances
2019-01-27 00:00:00+00:00,-39.51,8925.32,2019-01,groceries / food spend
2019-01-27 00:00:00+00:00,-7.56,8932.88,2019-01,shopping
2019-01-25 00:00:00+00:00,94.59,8838.29,2019-01,transfer
2019-01-25 00:00:00+00:00,-27.05,8865.34,2019-01,entertainment
2019-01-25 00:00:00+00:00,-3.61,8868.95,2019-01,transfer
2019-01-25 00:00:00+00:00,-0.39,8869.34,2019-01,savings
2019-01-25 00:00:00+00:00,-36.59,8905.93,2019-01,shopping
2019-01-25 00:00:00+00:00,-0.46,8906.39,2019-01,savings
2019-01-25 00:00:00+00:00,-10.5,8916.89,2019-01,entertainment
2019-01-23 00:00:00+00:00,-30.0,8946.89,2019-01,finances
2019-01-23 00:00:00+00:00,36.03,8910.86,2019-01,transfer
2019-01-23 00:00:00+00:00,-157.44,9068.3,2019-01,transfer
2019-01-23 00:00:00+00:00,-1.57,9069.87,2019-01,savings
2019-01-23 00:00:00+00:00,-33.56,9103.43,2019-01,transfer
2019-01-22 00:00:00+00:00,-3.58,9107.01,2019-01,shopping
2019-01-22 00:00:00+00:00,-0.01,9107.02,2019-01,savings
2019-01-22 00:00:00+00:00,-39.25,9146.27,2019-01,bills and utilities
2019-01-22 00:00:00+00:00,-0.34,9146.61,2019-01,shopping
2019-01-22 00:00:00+00:00,-36.59,9183.2,2019-01,finances
2019-01-20 00:00:00+00:00,-150.0,9333.2,2019-01,rent
2019-01-20 00:00:00+00:00,22.42,9310.78,2019-01,taxes
2019-01-20 00:00:00+00:00,-550.0,9860.78,2019-01,business services
2019-01-20 00:00:00+00:00,368.95,9491.83,2019-01,taxes
2019-01-19 00:00:00+00:00,-5.15,9496.98,2019-01,shopping
2019-01-19 00:00:00+00:00,1450.42,8046.56,2019-01,salary
2019-01-18 00:00:00+00:00,76.36,7970.2,2019-01,finances
2019-01-17 00:00:00+00:00,137.6,7832.6,2019-01,transfer
2019-01-17 00:00:00+00:00,-15.87,7848.47,2019-01,finances
2019-01-17 00:00:00+00:00,-40.0,7888.47,2019-01,finances
2019-01-17 00:00:00+00:00,-20.0,7908.47,2019-01,transport
2019-01-17 00:00:00+00:00,-0.56,7909.03,2019-01,savings
2019-01-17 00:00:00+00:00,-8.36,7917.39,2019-01,groceries / food spend
2019-01-15 00:00:00+00:00,-57.87,7975.26,2019-01,groceries / food spend
2019-01-15 00:00:00+00:00,-0.55,7975.81,2019-01,savings
2019-01-15 00:00:00+00:00,-15.45,7991.26,2019-01,shopping
2019-01-15 00:00:00+00:00,-0.41,7991.67,2019-01,savings
2019-01-15 00:00:00+00:00,-3.59,7995.26,2019-01,shopping
2019-01-15 00:00:00+00:00,-19.78,8015.04,2019-01,shopping
2019-01-14 00:00:00+00:00,-0.78,8015.82,2019-01,entertainment
2019-01-14 00:00:00+00:00,-20.5,8036.32,2019-01,entertainment
2019-01-14 00:00:00+00:00,105.64,7930.68,2019-01,entertainment
2019-01-12 00:00:00+00:00,-0.34,7931.02,2019-01,savings
2019-01-12 00:00:00+00:00,-23.11,7954.13,2019-01,transport
2019-01-11 00:00:00+00:00,50.0,7904.13,2019-01,finances
2019-01-11 00:00:00+00:00,31.08,7873.05,2019-01,transfer
2019-01-11 00:00:00+00:00,22.74,7850.31,2019-01,taxes
2019-01-11 00:00:00+00:00,-17.0,7867.31,2019-01,holidays
2019-01-10 00:00:00+00:00,-40.0,7907.31,2019-01,finances
2019-01-10 00:00:00+00:00,-5.0,7912.31,2019-01,groceries / food spend
2019-01-10 00:00:00+00:00,62.65,7849.66,2019-01,transfer
2019-01-10 00:00:00+00:00,48.5,7801.16,2019-01,finances
2019-01-10 00:00:00+00:00,-29.57,7830.73,2019-01,transfer
2019-01-10 00:00:00+00:00,-28.11,7858.84,2019-01,bills and utilities
2019-01-09 00:00:00+00:00,-23.62,7882.46,2019-01,transport
2019-01-09 00:00:00+00:00,-22.47,7904.93,2019-01,taxes
2019-01-09 00:00:00+00:00,-0.41,7905.34,2019-01,savings
2019-01-09 00:00:00+00:00,116.03,7789.31,2019-01,transfer
2019-01-08 00:00:00+00:00,-0.01,7789.32,2019-01,savings
2019-01-08 00:00:00+00:00,21.39,7767.93,2019-01,taxes
2019-01-08 00:00:00+00:00,-14.99,7782.92,2019-01,fees and charges
2019-01-08 00:00:00+00:00,-100.0,7882.92,2019-01,rent
2019-01-08 00:00:00+00:00,-19.61,7902.53,2019-01,entertainment
2019-01-08 00:00:00+00:00,-0.69,7903.22,2019-01,savings
2019-01-08 00:00:00+00:00,-1.04,7904.26,2019-01,savings
2019-01-08 00:00:00+00:00,-24.31,7928.57,2019-01,groceries / food spend
2019-01-07 00:00:00+00:00,-75.87,8004.44,2019-01,bills and utilities
2019-01-07 00:00:00+00:00,-1.06,8005.5,2019-01,savings
2019-01-07 00:00:00+00:00,-70.0,8075.5,2019-01,transfer
2019-01-06 00:00:00+00:00,-25.01,8100.51,2019-01,bills and utilities
2019-01-06 00:00:00+00:00,22.42,8078.09,2019-01,taxes
2019-01-06 00:00:00+00:00,-24.45,8102.54,2019-01,groceries / food spend
2019-01-06 00:00:00+00:00,-50.0,8152.54,2019-01,bills and utilities
2019-01-06 00:00:00+00:00,-9.71,8162.25,2019-01,home and garden
2019-01-06 00:00:00+00:00,352.89,7809.36,2019-01,taxes
2019-01-06 00:00:00+00:00,69.24,7740.12,2019-01,transfer
2019-01-06 00:00:00+00:00,41.86,7698.26,2019-01,transfer
2019-01-06 00:00:00+00:00,-0.01,7698.27,2019-01,savings
2019-01-06 00:00:00+00:00,-5.0,7703.27,2019-01,shopping
2019-01-05 00:00:00+00:00,-60.0,7763.27,2019-01,transfer
2019-01-05 00:00:00+00:00,-1.89,7765.16,2019-01,savings
2019-01-05 00:00:00+00:00,-5.63,7770.79,2019-01,finances
2019-01-05 00:00:00+00:00,-16.74,7787.53,2019-01,shopping
2019-01-05 00:00:00+00:00,-23.15,7810.68,2019-01,transfer
2019-01-05 00:00:00+00:00,-12.73,7823.41,2019-01,finances
2019-01-05 00:00:00+00:00,-2.7,7826.11,2019-01,groceries / food spend
2019-01-05 00:00:00+00:00,-20.0,7846.11,2019-01,shopping
2019-01-04 00:00:00+00:00,10.0,7836.11,2019-01,transfer
2019-01-04 00:00:00+00:00,70.0,7766.11,2019-01,transfer
2019-01-04 00:00:00+00:00,72.35,7693.76,2019-01,transfer
2019-01-04 00:00:00+00:00,-32.18,7725.94,2019-01,transfer
2019-01-04 00:00:00+00:00,-5.0,7730.94,2019-01,shopping
2019-01-04 00:00:00+00:00,-3.01,7733.95,2019-01,finances
2019-01-04 00:00:00+00:00,-100.0,7833.95,2019-01,transfer
2019-01-04 00:00:00+00:00,104.96,7728.99,2019-01,transfer
2019-01-04 00:00:00+00:00,-3.59,7732.58,2019-01,business services
2019-01-04 00:00:00+00:00,19.4,7713.18,2019-01,transfer
2019-01-04 00:00:00+00:00,-130.0,7843.18,2019-01,rent
2019-01-03 00:00:00+00:00,0.89,7842.29,2019-01,transfer
2019-01-03 00:00:00+00:00,-0.41,7842.7,2019-01,savings
2019-01-03 00:00:00+00:00,130.0,7712.7,2019-01,transfer
2019-01-03 00:00:00+00:00,7.0,7705.7,2019-01,transfer
2019-01-03 00:00:00+00:00,-23.11,7728.81,2019-01,transport
2019-01-03 00:00:00+00:00,35.49,7693.32,2019-01,entertainment
2019-01-03 00:00:00+00:00,-0.01,7693.33,2019-01,savings
2019-01-03 00:00:00+00:00,-2.94,7696.27,2019-01,entertainment
2019-01-03 00:00:00+00:00,-30.0,7726.27,2019-01,shopping
2019-01-03 00:00:00+00:00,40.0,7686.27,2019-01,transfer
2019-01-03 00:00:00+00:00,-17.16,7703.43,2019-01,transfer
2019-01-03 00:00:00+00:00,-2.11,7705.54,2019-01,groceries / food spend
2019-01-02 00:00:00+00:00,30.0,7675.54,2019-01,transfer
2019-01-02 00:00:00+00:00,-31.06,7706.6,2019-01,transfer
2019-01-02 00:00:00+00:00,10.0,7696.6,2019-01,transfer
2019-01-02 00:00:00+00:00,-0.59,7697.19,2019-01,savings
2019-01-01 00:00:00+00:00,-42.07,7739.26,2019-01,bills and utilities
2019-01-01 00:00:00+00:00,-0.01,7739.27,2019-01,fees and charges
2019-01-01 00:00:00+00:00,-32.17,7771.44,2019-01,transfer
2019-01-01 00:00:00+00:00,-39.99,7811.43,2019-01,groceries / food spend
2019-01-01 00:00:00+00:00,-0.01,7811.44,2019-01,finances
2019-01-01 00:00:00+00:00,-0.01,7811.45,2019-01,shopping
2019-01-01 00:00:00+00:00,-0.01,7811.46,2019-01,shopping
2019-01-01 00:00:00+00:00,-0.01,7811.47,2019-01,groceries / food spend
2019-01-01 00:00:00+00:00,-0.01,7811.48,2019-01,groceries / food spend
2019-01-01 00:00:00+00:00,-0.01,7811.49,2019-01,groceries / food spend
2019-01-01 00:00:00+00:00,-0.01,7811.5,2019-01,groceries / food spend
2019-01-01 00:00:00+00:00,-0.01,7811.51,2019-01,transport
2019-01-01 00:00:00+00:00,-65.09,7876.6,2019-01,restaurants / eating out / delivery
2019-01-01 00:00:00+00:00,-0.01,7876.61,2019-01,home and garden
2019-01-01 00:00:00+00:00,-0.01,7876.62,2019-01,fees and charges
2019-01-01 00:00:00+00:00,-0.0,7876.62,2019-01,transport
2019-01-01 00:00:00+00:00,-0.01,7876.63,2019-01,entertainment
2019-01-01 00:00:00+00:00,-0.01,7876.64,2019-01,fees and charges
2019-01-01 00:00:00+00:00,-37.45,7914.09,2019-01,groceries / food spend
2019-01-01 00:00:00+00:00,-20.91,7935.0,2019-01,transfer
2019-01-01 00:00:00+00:00,-10.0,7945.0,2019-01,business services
2019-01-01 00:00:00+00:00,-9.61,7954.61,2019-01,bills and utilities
2019-01-01 00:00:00+00:00,-10.43,7965.04,2019-01,finances
2019-01-01 00:00:00+00:00,-10.0,7975.04,2019-01,finances
2019-01-01 00:00:00+00:00,-9.87,7984.91,2019-01,bills and utilities
